"Borough/Census Area FIPS","Year","Age","Total","Male","Female","Data from: https://web.archive.org/web/20210611231927/https://live.laborstats.alaska.gov/pop/estimates/data/AgeBySexBCA.xls via https://web.archive.org/web/20210611231927/https://live.laborstats.alaska.gov/pop/index.cfm March 2023 "
"000",2010,"0-4",53996,27896,26100,
"000",2010,"5-9",50887,26038,24849,
"000",2010,"10-14",50816,26147,24669,
"000",2010,"15-19",52141,27179,24962,
"000",2010,"20-24",54419,29706,24713,
"000",2010,"25-29",55419,29307,26112,
"000",2010,"30-34",47706,24861,22845,
"000",2010,"35-39",45833,23731,22102,
"000",2010,"40-44",47141,24646,22495,
"000",2010,"45-49",54726,28398,26328,
"000",2010,"50-54",56300,29288,27012,
"000",2010,"55-59",49971,26394,23577,
"000",2010,"60-64",35938,19231,16707,
"000",2010,"65-69",22202,11714,10488,
"000",2010,"70-74",13148,6662,6486,
"000",2010,"75-79",8892,4150,4742,
"000",2010,"80-84",5985,2620,3365,
"000",2010,"85-89",3273,1217,2056,
"000",2010,"90+",1438,443,995,
"013",2010,"0-4",123,68,55,
"013",2010,"5-9",105,55,50,
"013",2010,"10-14",88,40,48,
"013",2010,"15-19",104,63,41,
"013",2010,"20-24",249,187,62,
"013",2010,"25-29",301,208,93,
"013",2010,"30-34",213,144,69,
"013",2010,"35-39",242,182,60,
"013",2010,"40-44",355,251,104,
"013",2010,"45-49",431,299,132,
"013",2010,"50-54",340,223,117,
"013",2010,"55-59",264,174,90,
"013",2010,"60-64",171,104,67,
"013",2010,"65-69",75,46,29,
"013",2010,"70-74",33,18,15,
"013",2010,"75-79",25,14,11,
"013",2010,"80-84",15,12,3,
"013",2010,"85-89",5,4,1,
"013",2010,"90+",2,1,1,
"016",2010,"0-4",205,106,99,
"016",2010,"5-9",227,113,114,
"016",2010,"10-14",226,129,97,
"016",2010,"15-19",249,149,100,
"016",2010,"20-24",334,233,101,
"016",2010,"25-29",517,375,142,
"016",2010,"30-34",455,319,136,
"016",2010,"35-39",477,344,133,
"016",2010,"40-44",660,464,196,
"016",2010,"45-49",627,432,195,
"016",2010,"50-54",605,420,185,
"016",2010,"55-59",458,299,159,
"016",2010,"60-64",328,222,106,
"016",2010,"65-69",110,70,40,
"016",2010,"70-74",47,34,13,
"016",2010,"75-79",17,8,9,
"016",2010,"80-84",14,6,8,
"016",2010,"85-89",4,0,4,
"016",2010,"90+",1,0,1,
"020",2010,"0-4",21961,11349,10612,
"020",2010,"5-9",20618,10542,10076,
"020",2010,"10-14",20443,10407,10036,
"020",2010,"15-19",21187,10990,10197,
"020",2010,"20-24",24379,13059,11320,
"020",2010,"25-29",24820,12820,12000,
"020",2010,"30-34",20620,10458,10162,
"020",2010,"35-39",19569,9843,9726,
"020",2010,"40-44",19493,9892,9601,
"020",2010,"45-49",22394,11157,11237,
"020",2010,"50-54",22175,11084,11091,
"020",2010,"55-59",19088,9755,9333,
"020",2010,"60-64",13940,7186,6754,
"020",2010,"65-69",8347,4169,4178,
"020",2010,"70-74",4962,2328,2634,
"020",2010,"75-79",3482,1533,1949,
"020",2010,"80-84",2386,978,1408,
"020",2010,"85-89",1342,470,872,
"020",2010,"90+",620,189,431,
"050",2010,"0-4",1796,911,885,
"050",2010,"5-9",1762,919,843,
"050",2010,"10-14",1669,871,798,
"050",2010,"15-19",1618,832,786,
"050",2010,"20-24",1349,688,661,
"050",2010,"25-29",1210,621,589,
"050",2010,"30-34",1047,536,511,
"050",2010,"35-39",893,457,436,
"050",2010,"40-44",965,534,431,
"050",2010,"45-49",1162,655,507,
"050",2010,"50-54",1048,579,469,
"050",2010,"55-59",850,451,399,
"050",2010,"60-64",603,330,273,
"050",2010,"65-69",451,234,217,
"050",2010,"70-74",213,117,96,
"050",2010,"75-79",194,76,118,
"050",2010,"80-84",114,56,58,
"050",2010,"85-89",45,21,24,
"050",2010,"90+",24,10,14,
"060",2010,"0-4",48,25,23,
"060",2010,"5-9",59,26,33,
"060",2010,"10-14",72,34,38,
"060",2010,"15-19",65,37,28,
"060",2010,"20-24",49,30,19,
"060",2010,"25-29",65,35,30,
"060",2010,"30-34",47,26,21,
"060",2010,"35-39",58,30,28,
"060",2010,"40-44",67,40,27,
"060",2010,"45-49",109,57,52,
"060",2010,"50-54",116,63,53,
"060",2010,"55-59",103,58,45,
"060",2010,"60-64",56,35,21,
"060",2010,"65-69",37,23,14,
"060",2010,"70-74",21,10,11,
"060",2010,"75-79",15,7,8,
"060",2010,"80-84",6,4,2,
"060",2010,"85-89",3,0,3,
"060",2010,"90+",1,0,1,
"063",2010,"0-4",441,215,226,
"063",2010,"5-9",419,217,202,
"063",2010,"10-14",464,231,233,
"063",2010,"15-19",471,253,218,
"063",2010,"20-24",402,233,169,
"063",2010,"25-29",451,254,197,
"063",2010,"30-34",385,213,172,
"063",2010,"35-39",402,206,196,
"063",2010,"40-44",492,259,233,
"063",2010,"45-49",617,342,275,
"063",2010,"50-54",708,382,326,
"063",2010,"55-59",569,319,250,
"063",2010,"60-64",386,208,178,
"063",2010,"65-69",218,125,93,
"063",2010,"70-74",117,59,58,
"063",2010,"75-79",64,32,32,
"063",2010,"80-84",41,18,23,
"063",2010,"85-89",25,8,17,
"063",2010,"90+",12,2,10,
"066",2010,"0-4",180,94,86,
"066",2010,"5-9",206,101,105,
"066",2010,"10-14",215,96,119,
"066",2010,"15-19",201,107,94,
"066",2010,"20-24",150,75,75,
"066",2010,"25-29",144,81,63,
"066",2010,"30-34",158,76,82,
"066",2010,"35-39",152,78,74,
"066",2010,"40-44",171,94,77,
"066",2010,"45-49",234,121,113,
"066",2010,"50-54",304,158,146,
"066",2010,"55-59",280,163,117,
"066",2010,"60-64",237,144,93,
"066",2010,"65-69",137,82,55,
"066",2010,"70-74",79,40,39,
"066",2010,"75-79",54,35,19,
"066",2010,"80-84",29,14,15,
"066",2010,"85-89",17,6,11,
"066",2010,"90+",7,4,3,
"068",2010,"0-4",114,64,50,
"068",2010,"5-9",114,59,55,
"068",2010,"10-14",118,54,64,
"068",2010,"15-19",97,52,45,
"068",2010,"20-24",49,28,21,
"068",2010,"25-29",96,40,56,
"068",2010,"30-34",136,66,70,
"068",2010,"35-39",138,70,68,
"068",2010,"40-44",131,73,58,
"068",2010,"45-49",189,109,80,
"068",2010,"50-54",191,110,81,
"068",2010,"55-59",198,111,87,
"068",2010,"60-64",118,81,37,
"068",2010,"65-69",73,44,29,
"068",2010,"70-74",37,22,15,
"068",2010,"75-79",19,14,5,
"068",2010,"80-84",5,3,2,
"068",2010,"85-89",2,2,0,
"068",2010,"90+",1,0,1,
"070",2010,"0-4",452,243,209,
"070",2010,"5-9",409,220,189,
"070",2010,"10-14",452,236,216,
"070",2010,"15-19",463,241,222,
"070",2010,"20-24",394,191,203,
"070",2010,"25-29",311,161,150,
"070",2010,"30-34",265,139,126,
"070",2010,"35-39",208,112,96,
"070",2010,"40-44",273,137,136,
"070",2010,"45-49",381,202,179,
"070",2010,"50-54",360,186,174,
"070",2010,"55-59",327,175,152,
"070",2010,"60-64",185,102,83,
"070",2010,"65-69",140,71,69,
"070",2010,"70-74",96,56,40,
"070",2010,"75-79",63,35,28,
"070",2010,"80-84",40,20,20,
"070",2010,"85-89",22,11,11,
"070",2010,"90+",6,3,3,
"090",2010,"0-4",7922,4114,3808,
"090",2010,"5-9",6985,3567,3418,
"090",2010,"10-14",6298,3274,3024,
"090",2010,"15-19",6778,3529,3249,
"090",2010,"20-24",10095,5789,4306,
"090",2010,"25-29",9030,5017,4013,
"090",2010,"30-34",7210,3809,3401,
"090",2010,"35-39",6492,3417,3075,
"090",2010,"40-44",5975,3105,2870,
"090",2010,"45-49",6625,3364,3261,
"090",2010,"50-54",6920,3536,3384,
"090",2010,"55-59",6301,3321,2980,
"090",2010,"60-64",4575,2501,2074,
"090",2010,"65-69",2637,1421,1216,
"090",2010,"70-74",1533,794,739,
"090",2010,"75-79",965,465,500,
"090",2010,"80-84",719,330,389,
"090",2010,"85-89",361,130,231,
"090",2010,"90+",160,48,112,
"100",2010,"0-4",128,61,67,
"100",2010,"5-9",135,62,73,
"100",2010,"10-14",141,84,57,
"100",2010,"15-19",135,64,71,
"100",2010,"20-24",79,41,38,
"100",2010,"25-29",115,55,60,
"100",2010,"30-34",131,67,64,
"100",2010,"35-39",144,70,74,
"100",2010,"40-44",161,83,78,
"100",2010,"45-49",228,119,109,
"100",2010,"50-54",250,132,118,
"100",2010,"55-59",274,140,134,
"100",2010,"60-64",242,131,111,
"100",2010,"65-69",138,70,68,
"100",2010,"70-74",78,37,41,
"100",2010,"75-79",67,28,39,
"100",2010,"80-84",32,19,13,
"100",2010,"85-89",21,8,13,
"100",2010,"90+",9,3,6,
"105",2010,"0-4",125,68,57,
"105",2010,"5-9",110,41,69,
"105",2010,"10-14",109,47,62,
"105",2010,"15-19",137,80,57,
"105",2010,"20-24",94,51,43,
"105",2010,"25-29",124,72,52,
"105",2010,"30-34",116,56,60,
"105",2010,"35-39",101,47,54,
"105",2010,"40-44",125,76,49,
"105",2010,"45-49",183,98,85,
"105",2010,"50-54",208,114,94,
"105",2010,"55-59",235,124,111,
"105",2010,"60-64",194,117,77,
"105",2010,"65-69",126,74,52,
"105",2010,"70-74",81,50,31,
"105",2010,"75-79",45,34,11,
"105",2010,"80-84",17,10,7,
"105",2010,"85-89",13,5,8,
"105",2010,"90+",6,0,6,
"110",2010,"0-4",1982,1017,965,
"110",2010,"5-9",1972,998,974,
"110",2010,"10-14",2011,1031,980,
"110",2010,"15-19",2212,1160,1052,
"110",2010,"20-24",1934,992,942,
"110",2010,"25-29",2308,1164,1144,
"110",2010,"30-34",2019,1059,960,
"110",2010,"35-39",2033,1052,981,
"110",2010,"40-44",2293,1171,1122,
"110",2010,"45-49",2669,1385,1284,
"110",2010,"50-54",2772,1407,1365,
"110",2010,"55-59",2575,1306,1269,
"110",2010,"60-64",1860,984,876,
"110",2010,"65-69",1055,515,540,
"110",2010,"70-74",667,344,323,
"110",2010,"75-79",368,156,212,
"110",2010,"80-84",298,122,176,
"110",2010,"85-89",171,66,105,
"110",2010,"90+",76,21,55,
"122",2010,"0-4",3464,1713,1751,
"122",2010,"5-9",3434,1773,1661,
"122",2010,"10-14",3762,1897,1865,
"122",2010,"15-19",3959,2123,1836,
"122",2010,"20-24",3066,1731,1335,
"122",2010,"25-29",3245,1746,1499,
"122",2010,"30-34",3045,1622,1423,
"122",2010,"35-39",3311,1754,1557,
"122",2010,"40-44",3544,1838,1706,
"122",2010,"45-49",4384,2287,2097,
"122",2010,"50-54",5143,2661,2482,
"122",2010,"55-59",5057,2646,2411,
"122",2010,"60-64",3710,1989,1721,
"122",2010,"65-69",2585,1441,1144,
"122",2010,"70-74",1479,794,685,
"122",2010,"75-79",1040,531,509,
"122",2010,"80-84",639,289,350,
"122",2010,"85-89",381,161,220,
"122",2010,"90+",152,42,110,
"130",2010,"0-4",903,454,449,
"130",2010,"5-9",857,455,402,
"130",2010,"10-14",876,435,441,
"130",2010,"15-19",937,491,446,
"130",2010,"20-24",824,445,379,
"130",2010,"25-29",983,521,462,
"130",2010,"30-34",834,432,402,
"130",2010,"35-39",783,379,404,
"130",2010,"40-44",916,463,453,
"130",2010,"45-49",1124,587,537,
"130",2010,"50-54",1175,613,562,
"130",2010,"55-59",1073,544,529,
"130",2010,"60-64",825,430,395,
"130",2010,"65-69",520,271,249,
"130",2010,"70-74",317,164,153,
"130",2010,"75-79",201,89,112,
"130",2010,"80-84",166,79,87,
"130",2010,"85-89",101,36,65,
"130",2010,"90+",62,23,39,
"150",2010,"0-4",1151,587,564,
"150",2010,"5-9",979,504,475,
"150",2010,"10-14",1123,601,522,
"150",2010,"15-19",1004,541,463,
"150",2010,"20-24",962,567,395,
"150",2010,"25-29",1068,576,492,
"150",2010,"30-34",955,489,466,
"150",2010,"35-39",854,446,408,
"150",2010,"40-44",936,474,462,
"150",2010,"45-49",1089,579,510,
"150",2010,"50-54",1041,573,468,
"150",2010,"55-59",875,471,404,
"150",2010,"60-64",640,345,295,
"150",2010,"65-69",403,201,202,
"150",2010,"70-74",238,122,116,
"150",2010,"75-79",126,59,67,
"150",2010,"80-84",76,31,45,
"150",2010,"85-89",45,19,26,
"150",2010,"90+",27,12,15,
"158",2010,"0-4",903,495,408,
"158",2010,"5-9",829,424,405,
"158",2010,"10-14",861,459,402,
"158",2010,"15-19",821,414,407,
"158",2010,"20-24",724,407,317,
"158",2010,"25-29",480,241,239,
"158",2010,"30-34",367,191,176,
"158",2010,"35-39",374,211,163,
"158",2010,"40-44",405,208,197,
"158",2010,"45-49",423,224,199,
"158",2010,"50-54",365,208,157,
"158",2010,"55-59",285,156,129,
"158",2010,"60-64",218,117,101,
"158",2010,"65-69",139,75,64,
"158",2010,"70-74",105,45,60,
"158",2010,"75-79",79,37,42,
"158",2010,"80-84",40,17,23,
"158",2010,"85-89",30,11,19,
"158",2010,"90+",11,4,7,
"164",2010,"0-4",138,67,71,
"164",2010,"5-9",122,63,59,
"164",2010,"10-14",138,67,71,
"164",2010,"15-19",149,73,76,
"164",2010,"20-24",129,63,66,
"164",2010,"25-29",124,64,60,
"164",2010,"30-34",102,58,44,
"164",2010,"35-39",76,41,35,
"164",2010,"40-44",86,49,37,
"164",2010,"45-49",134,80,54,
"164",2010,"50-54",140,83,57,
"164",2010,"55-59",95,47,48,
"164",2010,"60-64",71,36,35,
"164",2010,"65-69",56,31,25,
"164",2010,"70-74",35,19,16,
"164",2010,"75-79",15,9,6,
"164",2010,"80-84",11,7,4,
"164",2010,"85-89",6,1,5,
"164",2010,"90+",4,1,3,
"170",2010,"0-4",6900,3616,3284,
"170",2010,"5-9",7082,3631,3451,
"170",2010,"10-14",7189,3741,3448,
"170",2010,"15-19",6985,3580,3405,
"170",2010,"20-24",5009,2670,2339,
"170",2010,"25-29",5849,3011,2838,
"170",2010,"30-34",5738,2944,2794,
"170",2010,"35-39",5946,3006,2940,
"170",2010,"40-44",6234,3236,2998,
"170",2010,"45-49",7067,3642,3425,
"170",2010,"50-54",7279,3837,3442,
"170",2010,"55-59",6364,3341,3023,
"170",2010,"60-64",4284,2219,2065,
"170",2010,"65-69",2913,1559,1354,
"170",2010,"70-74",1712,890,822,
"170",2010,"75-79",1188,589,599,
"170",2010,"80-84",730,338,392,
"170",2010,"85-89",378,145,233,
"170",2010,"90+",148,45,103,
"180",2010,"0-4",1017,534,483,
"180",2010,"5-9",898,450,448,
"180",2010,"10-14",857,455,402,
"180",2010,"15-19",862,447,415,
"180",2010,"20-24",730,385,345,
"180",2010,"25-29",716,387,329,
"180",2010,"30-34",626,327,299,
"180",2010,"35-39",514,269,245,
"180",2010,"40-44",541,299,242,
"180",2010,"45-49",611,339,272,
"180",2010,"50-54",622,343,279,
"180",2010,"55-59",534,288,246,
"180",2010,"60-64",361,221,140,
"180",2010,"65-69",248,140,108,
"180",2010,"70-74",141,80,61,
"180",2010,"75-79",105,44,61,
"180",2010,"80-84",73,31,42,
"180",2010,"85-89",26,17,9,
"180",2010,"90+",10,2,8,
"185",2010,"0-4",747,382,365,
"185",2010,"5-9",620,317,303,
"185",2010,"10-14",553,291,262,
"185",2010,"15-19",629,324,305,
"185",2010,"20-24",752,443,309,
"185",2010,"25-29",750,453,297,
"185",2010,"30-34",650,426,224,
"185",2010,"35-39",585,411,174,
"185",2010,"40-44",638,428,210,
"185",2010,"45-49",837,555,282,
"185",2010,"50-54",974,689,285,
"185",2010,"55-59",839,635,204,
"185",2010,"60-64",454,324,130,
"185",2010,"65-69",191,124,67,
"185",2010,"70-74",90,50,40,
"185",2010,"75-79",53,22,31,
"185",2010,"80-84",47,22,25,
"185",2010,"85-89",17,6,11,
"185",2010,"90+",4,2,2,
"188",2010,"0-4",882,464,418,
"188",2010,"5-9",688,343,345,
"188",2010,"10-14",699,344,355,
"188",2010,"15-19",710,373,337,
"188",2010,"20-24",708,388,320,
"188",2010,"25-29",550,270,280,
"188",2010,"30-34",430,244,186,
"188",2010,"35-39",399,220,179,
"188",2010,"40-44",442,267,175,
"188",2010,"45-49",488,282,206,
"188",2010,"50-54",454,258,196,
"188",2010,"55-59",356,220,136,
"188",2010,"60-64",262,141,121,
"188",2010,"65-69",146,80,66,
"188",2010,"70-74",118,69,49,
"188",2010,"75-79",94,36,58,
"188",2010,"80-84",61,19,42,
"188",2010,"85-89",28,9,19,
"188",2010,"90+",8,2,6,
"195",2010,"0-4",186,93,93,
"195",2010,"5-9",183,79,104,
"195",2010,"10-14",243,140,103,
"195",2010,"15-19",203,94,109,
"195",2010,"20-24",165,85,80,
"195",2010,"25-29",196,97,99,
"195",2010,"30-34",174,91,83,
"195",2010,"35-39",176,84,92,
"195",2010,"40-44",215,111,104,
"195",2010,"45-49",262,135,127,
"195",2010,"50-54",300,144,156,
"195",2010,"55-59",296,162,134,
"195",2010,"60-64",235,127,108,
"195",2010,"65-69",168,109,59,
"195",2010,"70-74",66,36,30,
"195",2010,"75-79",54,24,30,
"195",2010,"80-84",44,21,23,
"195",2010,"85-89",24,11,13,
"195",2010,"90+",13,7,6,
"198",2010,"0-4",457,239,218,
"198",2010,"5-9",402,210,192,
"198",2010,"10-14",456,251,205,
"198",2010,"15-19",390,229,161,
"198",2010,"20-24",340,180,160,
"198",2010,"25-29",325,177,148,
"198",2010,"30-34",338,181,157,
"198",2010,"35-39",376,192,184,
"198",2010,"40-44",419,224,195,
"198",2010,"45-49",528,297,231,
"198",2010,"50-54",535,287,248,
"198",2010,"55-59",564,319,245,
"198",2010,"60-64",414,251,163,
"198",2010,"65-69",285,167,118,
"198",2010,"70-74",162,102,60,
"198",2010,"75-79",102,60,42,
"198",2010,"80-84",52,23,29,
"198",2010,"85-89",20,11,9,
"198",2010,"90+",7,3,4,
"220",2010,"0-4",624,343,281,
"220",2010,"5-9",561,278,283,
"220",2010,"10-14",546,302,244,
"220",2010,"15-19",560,283,277,
"220",2010,"20-24",519,242,277,
"220",2010,"25-29",613,299,314,
"220",2010,"30-34",641,330,311,
"220",2010,"35-39",604,311,293,
"220",2010,"40-44",561,297,264,
"220",2010,"45-49",649,333,316,
"220",2010,"50-54",787,391,396,
"220",2010,"55-59",696,350,346,
"220",2010,"60-64",512,281,231,
"220",2010,"65-69",319,166,153,
"220",2010,"70-74",257,119,138,
"220",2010,"75-79",165,68,97,
"220",2010,"80-84",130,53,77,
"220",2010,"85-89",102,27,75,
"220",2010,"90+",35,8,27,
"230",2010,"0-4",49,27,22,
"230",2010,"5-9",33,18,15,
"230",2010,"10-14",35,17,18,
"230",2010,"15-19",46,20,26,
"230",2010,"20-24",39,19,20,
"230",2010,"25-29",82,36,46,
"230",2010,"30-34",107,47,60,
"230",2010,"35-39",66,40,26,
"230",2010,"40-44",93,52,41,
"230",2010,"45-49",68,36,32,
"230",2010,"50-54",88,48,40,
"230",2010,"55-59",103,61,42,
"230",2010,"60-64",71,41,30,
"230",2010,"65-69",41,16,25,
"230",2010,"70-74",22,14,8,
"230",2010,"75-79",9,2,7,
"230",2010,"80-84",10,4,6,
"230",2010,"85-89",6,2,4,
"230",2010,"90+",0,0,0,
"240",2010,"0-4",486,236,250,
"240",2010,"5-9",529,304,225,
"240",2010,"10-14",509,273,236,
"240",2010,"15-19",510,267,243,
"240",2010,"20-24",377,192,185,
"240",2010,"25-29",433,246,187,
"240",2010,"30-34",460,267,193,
"240",2010,"35-39",429,235,194,
"240",2010,"40-44",483,284,199,
"240",2010,"45-49",566,334,232,
"240",2010,"50-54",605,328,277,
"240",2010,"55-59",562,330,232,
"240",2010,"60-64",415,254,161,
"240",2010,"65-69",274,173,101,
"240",2010,"70-74",188,100,88,
"240",2010,"75-79",99,52,47,
"240",2010,"80-84",63,29,34,
"240",2010,"85-89",27,9,18,
"240",2010,"90+",11,2,9,
"275",2010,"0-4",129,60,69,
"275",2010,"5-9",136,65,71,
"275",2010,"10-14",155,84,71,
"275",2010,"15-19",152,86,66,
"275",2010,"20-24",116,70,46,
"275",2010,"25-29",115,60,55,
"275",2010,"30-34",88,42,46,
"275",2010,"35-39",114,59,55,
"275",2010,"40-44",127,57,70,
"275",2010,"45-49",186,102,84,
"275",2010,"50-54",243,130,113,
"275",2010,"55-59",235,123,112,
"275",2010,"60-64",199,110,89,
"275",2010,"65-69",123,64,59,
"275",2010,"70-74",110,62,48,
"275",2010,"75-79",66,36,30,
"275",2010,"80-84",42,21,21,
"275",2010,"85-89",21,8,13,
"275",2010,"90+",12,3,9,
"282",2010,"0-4",40,17,23,
"282",2010,"5-9",42,22,20,
"282",2010,"10-14",41,19,22,
"282",2010,"15-19",53,28,25,
"282",2010,"20-24",34,16,18,
"282",2010,"25-29",42,27,15,
"282",2010,"30-34",36,17,19,
"282",2010,"35-39",46,28,18,
"282",2010,"40-44",48,28,20,
"282",2010,"45-49",56,35,21,
"282",2010,"50-54",54,32,22,
"282",2010,"55-59",60,39,21,
"282",2010,"60-64",46,24,22,
"282",2010,"65-69",23,14,9,
"282",2010,"70-74",20,12,8,
"282",2010,"75-79",9,1,8,
"282",2010,"80-84",7,0,7,
"282",2010,"85-89",5,1,4,
"282",2010,"90+",0,0,0,
"290",2010,"0-4",443,234,209,
"290",2010,"5-9",371,182,189,
"290",2010,"10-14",467,237,230,
"290",2010,"15-19",454,249,205,
"290",2010,"20-24",368,206,162,
"290",2010,"25-29",356,193,163,
"290",2010,"30-34",313,185,128,
"290",2010,"35-39",271,137,134,
"290",2010,"40-44",292,152,140,
"290",2010,"45-49",405,211,194,
"290",2010,"50-54",498,269,229,
"290",2010,"55-59",455,266,189,
"290",2010,"60-64",326,176,150,
"290",2010,"65-69",224,139,85,
"290",2010,"70-74",124,75,49,
"290",2010,"75-79",109,54,55,
"290",2010,"80-84",78,44,34,
"290",2010,"85-89",25,12,13,
"290",2010,"90+",9,6,3,
"000",2011,"0-4",55281,28466,26815,
"000",2011,"5-9",51504,26402,25102,
"000",2011,"10-14",51298,26359,24939,
"000",2011,"15-19",50648,26395,24253,
"000",2011,"20-24",55220,30096,25124,
"000",2011,"25-29",57268,30339,26929,
"000",2011,"30-34",50483,26214,24269,
"000",2011,"35-39",44792,23225,21567,
"000",2011,"40-44",47115,24559,22556,
"000",2011,"45-49",52228,27039,25189,
"000",2011,"50-54",56549,29419,27130,
"000",2011,"55-59",51923,27145,24778,
"000",2011,"60-64",39378,20983,18395,
"000",2011,"65-69",23672,12452,11220,
"000",2011,"70-74",14406,7392,7014,
"000",2011,"75-79",9274,4401,4873,
"000",2011,"80-84",6331,2787,3544,
"000",2011,"85-89",3472,1283,2189,
"000",2011,"90+",1631,512,1119,
"013",2011,"0-4",124,67,57,
"013",2011,"5-9",112,55,57,
"013",2011,"10-14",77,37,40,
"013",2011,"15-19",107,61,46,
"013",2011,"20-24",263,197,66,
"013",2011,"25-29",245,181,64,
"013",2011,"30-34",243,151,92,
"013",2011,"35-39",235,160,75,
"013",2011,"40-44",325,249,76,
"013",2011,"45-49",404,285,119,
"013",2011,"50-54",369,231,138,
"013",2011,"55-59",291,206,85,
"013",2011,"60-64",176,107,69,
"013",2011,"65-69",94,58,36,
"013",2011,"70-74",45,25,20,
"013",2011,"75-79",16,8,8,
"013",2011,"80-84",16,13,3,
"013",2011,"85-89",5,4,1,
"013",2011,"90+",1,1,0,
"016",2011,"0-4",209,103,106,
"016",2011,"5-9",203,109,94,
"016",2011,"10-14",221,128,93,
"016",2011,"15-19",262,159,103,
"016",2011,"20-24",299,201,98,
"016",2011,"25-29",492,379,113,
"016",2011,"30-34",454,319,135,
"016",2011,"35-39",491,349,142,
"016",2011,"40-44",592,422,170,
"016",2011,"45-49",599,406,193,
"016",2011,"50-54",663,452,211,
"016",2011,"55-59",458,313,145,
"016",2011,"60-64",341,229,112,
"016",2011,"65-69",150,96,54,
"016",2011,"70-74",51,33,18,
"016",2011,"75-79",15,10,5,
"016",2011,"80-84",15,6,9,
"016",2011,"85-89",6,2,4,
"016",2011,"90+",1,0,1,
"020",2011,"0-4",22339,11586,10753,
"020",2011,"5-9",20671,10579,10092,
"020",2011,"10-14",20605,10578,10027,
"020",2011,"15-19",20447,10516,9931,
"020",2011,"20-24",24644,13194,11450,
"020",2011,"25-29",25550,13215,12335,
"020",2011,"30-34",21848,11050,10798,
"020",2011,"35-39",18895,9530,9365,
"020",2011,"40-44",19691,9987,9704,
"020",2011,"45-49",21323,10571,10752,
"020",2011,"50-54",22230,11155,11075,
"020",2011,"55-59",19846,9998,9848,
"020",2011,"60-64",15034,7709,7325,
"020",2011,"65-69",9070,4552,4518,
"020",2011,"70-74",5274,2506,2768,
"020",2011,"75-79",3639,1636,2003,
"020",2011,"80-84",2524,1033,1491,
"020",2011,"85-89",1366,496,870,
"020",2011,"90+",717,219,498,
"050",2011,"0-4",1850,940,910,
"050",2011,"5-9",1755,917,838,
"050",2011,"10-14",1742,892,850,
"050",2011,"15-19",1588,810,778,
"050",2011,"20-24",1418,697,721,
"050",2011,"25-29",1326,692,634,
"050",2011,"30-34",1065,536,529,
"050",2011,"35-39",890,446,444,
"050",2011,"40-44",964,512,452,
"050",2011,"45-49",1152,651,501,
"050",2011,"50-54",1074,611,463,
"050",2011,"55-59",910,481,429,
"050",2011,"60-64",639,336,303,
"050",2011,"65-69",427,230,197,
"050",2011,"70-74",255,132,123,
"050",2011,"75-79",216,92,124,
"050",2011,"80-84",108,47,61,
"050",2011,"85-89",51,27,24,
"050",2011,"90+",20,10,10,
"060",2011,"0-4",40,22,18,
"060",2011,"5-9",58,30,28,
"060",2011,"10-14",64,34,30,
"060",2011,"15-19",78,36,42,
"060",2011,"20-24",48,28,20,
"060",2011,"25-29",88,46,42,
"060",2011,"30-34",43,22,21,
"060",2011,"35-39",58,29,29,
"060",2011,"40-44",79,47,32,
"060",2011,"45-49",97,51,46,
"060",2011,"50-54",112,63,49,
"060",2011,"55-59",97,53,44,
"060",2011,"60-64",71,46,25,
"060",2011,"65-69",42,24,18,
"060",2011,"70-74",17,10,7,
"060",2011,"75-79",18,8,10,
"060",2011,"80-84",9,6,3,
"060",2011,"85-89",3,0,3,
"060",2011,"90+",2,0,2,
"063",2011,"0-4",478,229,249,
"063",2011,"5-9",412,209,203,
"063",2011,"10-14",435,212,223,
"063",2011,"15-19",449,248,201,
"063",2011,"20-24",399,222,177,
"063",2011,"25-29",515,292,223,
"063",2011,"30-34",422,232,190,
"063",2011,"35-39",402,218,184,
"063",2011,"40-44",490,254,236,
"063",2011,"45-49",564,309,255,
"063",2011,"50-54",690,379,311,
"063",2011,"55-59",617,333,284,
"063",2011,"60-64",420,230,190,
"063",2011,"65-69",235,136,99,
"063",2011,"70-74",116,52,64,
"063",2011,"75-79",77,43,34,
"063",2011,"80-84",47,22,25,
"063",2011,"85-89",25,7,18,
"063",2011,"90+",12,3,9,
"066",2011,"0-4",193,96,97,
"066",2011,"5-9",201,104,97,
"066",2011,"10-14",220,99,121,
"066",2011,"15-19",211,109,102,
"066",2011,"20-24",157,76,81,
"066",2011,"25-29",141,80,61,
"066",2011,"30-34",179,85,94,
"066",2011,"35-39",134,69,65,
"066",2011,"40-44",171,93,78,
"066",2011,"45-49",208,102,106,
"066",2011,"50-54",321,167,154,
"066",2011,"55-59",288,168,120,
"066",2011,"60-64",272,173,99,
"066",2011,"65-69",130,74,56,
"066",2011,"70-74",93,50,43,
"066",2011,"75-79",58,37,21,
"066",2011,"80-84",27,16,11,
"066",2011,"85-89",16,4,12,
"066",2011,"90+",10,5,5,
"068",2011,"0-4",113,75,38,
"068",2011,"5-9",111,65,46,
"068",2011,"10-14",123,55,68,
"068",2011,"15-19",95,42,53,
"068",2011,"20-24",45,25,20,
"068",2011,"25-29",98,45,53,
"068",2011,"30-34",145,78,67,
"068",2011,"35-39",120,61,59,
"068",2011,"40-44",134,68,66,
"068",2011,"45-49",182,98,84,
"068",2011,"50-54",183,116,67,
"068",2011,"55-59",197,111,86,
"068",2011,"60-64",129,89,40,
"068",2011,"65-69",73,41,32,
"068",2011,"70-74",54,32,22,
"068",2011,"75-79",22,17,5,
"068",2011,"80-84",9,3,6,
"068",2011,"85-89",1,1,0,
"068",2011,"90+",1,1,0,
"070",2011,"0-4",487,257,230,
"070",2011,"5-9",410,215,195,
"070",2011,"10-14",440,231,209,
"070",2011,"15-19",464,248,216,
"070",2011,"20-24",398,201,197,
"070",2011,"25-29",340,176,164,
"070",2011,"30-34",288,141,147,
"070",2011,"35-39",219,120,99,
"070",2011,"40-44",249,133,116,
"070",2011,"45-49",372,182,190,
"070",2011,"50-54",347,190,157,
"070",2011,"55-59",335,174,161,
"070",2011,"60-64",204,111,93,
"070",2011,"65-69",144,81,63,
"070",2011,"70-74",113,55,58,
"070",2011,"75-79",61,34,27,
"070",2011,"80-84",38,20,18,
"070",2011,"85-89",18,7,11,
"070",2011,"90+",8,6,2,
"090",2011,"0-4",8030,4162,3868,
"090",2011,"5-9",7002,3527,3475,
"090",2011,"10-14",6387,3295,3092,
"090",2011,"15-19",6437,3370,3067,
"090",2011,"20-24",9878,5658,4220,
"090",2011,"25-29",9209,5091,4118,
"090",2011,"30-34",7595,4089,3506,
"090",2011,"35-39",6371,3317,3054,
"090",2011,"40-44",6004,3171,2833,
"090",2011,"45-49",6318,3196,3122,
"090",2011,"50-54",6834,3494,3340,
"090",2011,"55-59",6473,3336,3137,
"090",2011,"60-64",4915,2648,2267,
"090",2011,"65-69",2831,1534,1297,
"090",2011,"70-74",1703,876,827,
"090",2011,"75-79",997,511,486,
"090",2011,"80-84",733,334,399,
"090",2011,"85-89",393,130,263,
"090",2011,"90+",175,56,119,
"100",2011,"0-4",133,57,76,
"100",2011,"5-9",144,75,69,
"100",2011,"10-14",133,78,55,
"100",2011,"15-19",136,66,70,
"100",2011,"20-24",84,49,35,
"100",2011,"25-29",126,69,57,
"100",2011,"30-34",148,68,80,
"100",2011,"35-39",145,67,78,
"100",2011,"40-44",185,94,91,
"100",2011,"45-49",196,104,92,
"100",2011,"50-54",241,123,118,
"100",2011,"55-59",290,153,137,
"100",2011,"60-64",253,136,117,
"100",2011,"65-69",160,79,81,
"100",2011,"70-74",88,44,44,
"100",2011,"75-79",63,26,37,
"100",2011,"80-84",51,24,27,
"100",2011,"85-89",24,10,14,
"100",2011,"90+",13,6,7,
"105",2011,"0-4",127,66,61,
"105",2011,"5-9",108,47,61,
"105",2011,"10-14",123,54,69,
"105",2011,"15-19",114,65,49,
"105",2011,"20-24",99,54,45,
"105",2011,"25-29",125,70,55,
"105",2011,"30-34",111,58,53,
"105",2011,"35-39",113,53,60,
"105",2011,"40-44",111,66,45,
"105",2011,"45-49",149,78,71,
"105",2011,"50-54",215,112,103,
"105",2011,"55-59",239,128,111,
"105",2011,"60-64",205,121,84,
"105",2011,"65-69",135,84,51,
"105",2011,"70-74",83,53,30,
"105",2011,"75-79",49,36,13,
"105",2011,"80-84",21,14,7,
"105",2011,"85-89",12,4,8,
"105",2011,"90+",11,3,8,
"110",2011,"0-4",2043,1028,1015,
"110",2011,"5-9",2005,1021,984,
"110",2011,"10-14",2047,1049,998,
"110",2011,"15-19",2170,1150,1020,
"110",2011,"20-24",1993,1013,980,
"110",2011,"25-29",2538,1301,1237,
"110",2011,"30-34",2158,1132,1026,
"110",2011,"35-39",2038,1048,990,
"110",2011,"40-44",2286,1174,1112,
"110",2011,"45-49",2589,1331,1258,
"110",2011,"50-54",2909,1498,1411,
"110",2011,"55-59",2622,1296,1326,
"110",2011,"60-64",2104,1124,980,
"110",2011,"65-69",1140,559,581,
"110",2011,"70-74",721,370,351,
"110",2011,"75-79",400,171,229,
"110",2011,"80-84",312,130,182,
"110",2011,"85-89",188,71,117,
"110",2011,"90+",82,20,62,
"122",2011,"0-4",3582,1786,1796,
"122",2011,"5-9",3490,1789,1701,
"122",2011,"10-14",3773,1894,1879,
"122",2011,"15-19",3831,2048,1783,
"122",2011,"20-24",3156,1783,1373,
"122",2011,"25-29",3390,1883,1507,
"122",2011,"30-34",3172,1646,1526,
"122",2011,"35-39",3194,1685,1509,
"122",2011,"40-44",3590,1892,1698,
"122",2011,"45-49",4080,2111,1969,
"122",2011,"50-54",5102,2612,2490,
"122",2011,"55-59",5289,2749,2540,
"122",2011,"60-64",4138,2217,1921,
"122",2011,"65-69",2719,1497,1222,
"122",2011,"70-74",1613,891,722,
"122",2011,"75-79",1104,556,548,
"122",2011,"80-84",696,332,364,
"122",2011,"85-89",396,170,226,
"122",2011,"90+",197,53,144,
"130",2011,"0-4",938,456,482,
"130",2011,"5-9",849,452,397,
"130",2011,"10-14",871,448,423,
"130",2011,"15-19",912,485,427,
"130",2011,"20-24",869,464,405,
"130",2011,"25-29",1007,523,484,
"130",2011,"30-34",874,463,411,
"130",2011,"35-39",774,378,396,
"130",2011,"40-44",946,470,476,
"130",2011,"45-49",1028,532,496,
"130",2011,"50-54",1155,602,553,
"130",2011,"55-59",1130,569,561,
"130",2011,"60-64",921,487,434,
"130",2011,"65-69",544,276,268,
"130",2011,"70-74",367,193,174,
"130",2011,"75-79",196,92,104,
"130",2011,"80-84",193,91,102,
"130",2011,"85-89",98,34,64,
"130",2011,"90+",60,19,41,
"150",2011,"0-4",1211,633,578,
"150",2011,"5-9",990,493,497,
"150",2011,"10-14",1092,575,517,
"150",2011,"15-19",980,525,455,
"150",2011,"20-24",1010,582,428,
"150",2011,"25-29",1081,609,472,
"150",2011,"30-34",1059,525,534,
"150",2011,"35-39",819,449,370,
"150",2011,"40-44",885,442,443,
"150",2011,"45-49",1028,538,490,
"150",2011,"50-54",1087,593,494,
"150",2011,"55-59",917,503,414,
"150",2011,"60-64",677,347,330,
"150",2011,"65-69",424,217,207,
"150",2011,"70-74",261,135,126,
"150",2011,"75-79",148,69,79,
"150",2011,"80-84",87,37,50,
"150",2011,"85-89",47,20,27,
"150",2011,"90+",34,16,18,
"158",2011,"0-4",942,498,444,
"158",2011,"5-9",844,436,408,
"158",2011,"10-14",888,460,428,
"158",2011,"15-19",800,403,397,
"158",2011,"20-24",738,411,327,
"158",2011,"25-29",559,275,284,
"158",2011,"30-34",378,204,174,
"158",2011,"35-39",387,212,175,
"158",2011,"40-44",387,196,191,
"158",2011,"45-49",410,221,189,
"158",2011,"50-54",389,212,177,
"158",2011,"55-59",290,160,130,
"158",2011,"60-64",246,129,117,
"158",2011,"65-69",156,88,68,
"158",2011,"70-74",93,42,51,
"158",2011,"75-79",82,36,46,
"158",2011,"80-84",39,16,23,
"158",2011,"85-89",35,13,22,
"158",2011,"90+",12,4,8,
"164",2011,"0-4",148,76,72,
"164",2011,"5-9",127,68,59,
"164",2011,"10-14",117,51,66,
"164",2011,"15-19",143,81,62,
"164",2011,"20-24",140,69,71,
"164",2011,"25-29",121,59,62,
"164",2011,"30-34",116,66,50,
"164",2011,"35-39",96,52,44,
"164",2011,"40-44",66,38,28,
"164",2011,"45-49",133,76,57,
"164",2011,"50-54",142,82,60,
"164",2011,"55-59",119,70,49,
"164",2011,"60-64",70,35,35,
"164",2011,"65-69",61,35,26,
"164",2011,"70-74",37,19,18,
"164",2011,"75-79",14,9,5,
"164",2011,"80-84",14,11,3,
"164",2011,"85-89",10,2,8,
"164",2011,"90+",3,1,2,
"170",2011,"0-4",7015,3618,3397,
"170",2011,"5-9",7431,3852,3579,
"170",2011,"10-14",7318,3765,3553,
"170",2011,"15-19",7098,3697,3401,
"170",2011,"20-24",5212,2808,2404,
"170",2011,"25-29",5948,3013,2935,
"170",2011,"30-34",6106,3072,3034,
"170",2011,"35-39",5810,2964,2846,
"170",2011,"40-44",6361,3264,3097,
"170",2011,"45-49",6837,3556,3281,
"170",2011,"50-54",7411,3866,3545,
"170",2011,"55-59",6614,3468,3146,
"170",2011,"60-64",4939,2562,2377,
"170",2011,"65-69",3046,1590,1456,
"170",2011,"70-74",1991,1069,922,
"170",2011,"75-79",1191,583,608,
"170",2011,"80-84",779,372,407,
"170",2011,"85-89",455,156,299,
"170",2011,"90+",150,50,100,
"180",2011,"0-4",1067,562,505,
"180",2011,"5-9",927,470,457,
"180",2011,"10-14",891,473,418,
"180",2011,"15-19",819,435,384,
"180",2011,"20-24",774,409,365,
"180",2011,"25-29",765,415,350,
"180",2011,"30-34",608,324,284,
"180",2011,"35-39",564,296,268,
"180",2011,"40-44",501,282,219,
"180",2011,"45-49",606,327,279,
"180",2011,"50-54",631,349,282,
"180",2011,"55-59",545,294,251,
"180",2011,"60-64",401,236,165,
"180",2011,"65-69",242,133,109,
"180",2011,"70-74",148,88,60,
"180",2011,"75-79",116,48,68,
"180",2011,"80-84",68,29,39,
"180",2011,"85-89",30,17,13,
"180",2011,"90+",9,2,7,
"185",2011,"0-4",765,386,379,
"185",2011,"5-9",667,340,327,
"185",2011,"10-14",566,299,267,
"185",2011,"15-19",569,288,281,
"185",2011,"20-24",795,476,319,
"185",2011,"25-29",790,478,312,
"185",2011,"30-34",684,443,241,
"185",2011,"35-39",592,422,170,
"185",2011,"40-44",529,343,186,
"185",2011,"45-49",883,608,275,
"185",2011,"50-54",933,655,278,
"185",2011,"55-59",902,675,227,
"185",2011,"60-64",487,345,142,
"185",2011,"65-69",209,141,68,
"185",2011,"70-74",91,49,42,
"185",2011,"75-79",52,19,33,
"185",2011,"80-84",39,18,21,
"185",2011,"85-89",24,8,16,
"185",2011,"90+",2,0,2,
"188",2011,"0-4",903,480,423,
"188",2011,"5-9",726,357,369,
"188",2011,"10-14",698,347,351,
"188",2011,"15-19",633,324,309,
"188",2011,"20-24",772,421,351,
"188",2011,"25-29",578,289,289,
"188",2011,"30-34",482,275,207,
"188",2011,"35-39",377,209,168,
"188",2011,"40-44",403,232,171,
"188",2011,"45-49",477,279,198,
"188",2011,"50-54",464,265,199,
"188",2011,"55-59",389,236,153,
"188",2011,"60-64",270,156,114,
"188",2011,"65-69",160,78,82,
"188",2011,"70-74",126,73,53,
"188",2011,"75-79",85,34,51,
"188",2011,"80-84",62,21,41,
"188",2011,"85-89",31,9,22,
"188",2011,"90+",5,2,3,
"195",2011,"0-4",211,107,104,
"195",2011,"5-9",166,78,88,
"195",2011,"10-14",253,143,110,
"195",2011,"15-19",202,101,101,
"195",2011,"20-24",182,89,93,
"195",2011,"25-29",198,101,97,
"195",2011,"30-34",191,98,93,
"195",2011,"35-39",172,83,89,
"195",2011,"40-44",224,119,105,
"195",2011,"45-49",257,125,132,
"195",2011,"50-54",278,140,138,
"195",2011,"55-59",308,161,147,
"195",2011,"60-64",255,142,113,
"195",2011,"65-69",180,116,64,
"195",2011,"70-74",88,44,44,
"195",2011,"75-79",48,28,20,
"195",2011,"80-84",40,16,24,
"195",2011,"85-89",28,12,16,
"195",2011,"90+",12,4,8,
"198",2011,"0-4",469,229,240,
"198",2011,"5-9",451,248,203,
"198",2011,"10-14",451,245,206,
"198",2011,"15-19",410,238,172,
"198",2011,"20-24",364,202,162,
"198",2011,"25-29",350,195,155,
"198",2011,"30-34",379,200,179,
"198",2011,"35-39",369,197,172,
"198",2011,"40-44",434,220,214,
"198",2011,"45-49",502,284,218,
"198",2011,"50-54",553,284,269,
"198",2011,"55-59",589,339,250,
"198",2011,"60-64",449,266,183,
"198",2011,"65-69",294,173,121,
"198",2011,"70-74",190,119,71,
"198",2011,"75-79",118,72,46,
"198",2011,"80-84",62,24,38,
"198",2011,"85-89",20,11,9,
"198",2011,"90+",8,5,3,
"220",2011,"0-4",657,335,322,
"220",2011,"5-9",555,277,278,
"220",2011,"10-14",531,290,241,
"220",2011,"15-19",550,276,274,
"220",2011,"20-24",501,251,250,
"220",2011,"25-29",653,285,368,
"220",2011,"30-34",662,350,312,
"220",2011,"35-39",614,319,295,
"220",2011,"40-44",555,293,262,
"220",2011,"45-49",611,324,287,
"220",2011,"50-54",747,365,382,
"220",2011,"55-59",721,352,369,
"220",2011,"60-64",595,325,270,
"220",2011,"65-69",324,166,158,
"220",2011,"70-74",281,142,139,
"220",2011,"75-79",178,68,110,
"220",2011,"80-84",132,57,75,
"220",2011,"85-89",101,26,75,
"220",2011,"90+",45,12,33,
"230",2011,"0-4",54,25,29,
"230",2011,"5-9",23,11,12,
"230",2011,"10-14",35,18,17,
"230",2011,"15-19",40,17,23,
"230",2011,"20-24",40,22,18,
"230",2011,"25-29",74,33,41,
"230",2011,"30-34",102,47,55,
"230",2011,"35-39",60,36,24,
"230",2011,"40-44",91,43,48,
"230",2011,"45-49",76,43,33,
"230",2011,"50-54",86,44,42,
"230",2011,"55-59",105,67,38,
"230",2011,"60-64",77,40,37,
"230",2011,"65-69",40,17,23,
"230",2011,"70-74",27,17,10,
"230",2011,"75-79",17,3,14,
"230",2011,"80-84",9,0,9,
"230",2011,"85-89",7,5,2,
"230",2011,"90+",1,0,1,
"240",2011,"0-4",508,247,261,
"240",2011,"5-9",522,292,230,
"240",2011,"10-14",525,280,245,
"240",2011,"15-19",483,257,226,
"240",2011,"20-24",410,207,203,
"240",2011,"25-29",437,256,181,
"240",2011,"30-34",511,271,240,
"240",2011,"35-39",414,236,178,
"240",2011,"40-44",455,265,190,
"240",2011,"45-49",529,309,220,
"240",2011,"50-54",612,347,265,
"240",2011,"55-59",568,317,251,
"240",2011,"60-64",461,290,171,
"240",2011,"65-69",252,161,91,
"240",2011,"70-74",203,108,95,
"240",2011,"75-79",106,60,46,
"240",2011,"80-84",68,29,39,
"240",2011,"85-89",27,11,16,
"240",2011,"90+",13,4,9,
"275",2011,"0-4",140,67,73,
"275",2011,"5-9",136,71,65,
"275",2011,"10-14",166,90,76,
"275",2011,"15-19",135,76,59,
"275",2011,"20-24",122,65,57,
"275",2011,"25-29",140,71,69,
"275",2011,"30-34",92,50,42,
"275",2011,"35-39",105,50,55,
"275",2011,"40-44",116,48,68,
"275",2011,"45-49",174,103,71,
"275",2011,"50-54",233,117,116,
"275",2011,"55-59",257,133,124,
"275",2011,"60-64",201,115,86,
"275",2011,"65-69",132,66,66,
"275",2011,"70-74",108,60,48,
"275",2011,"75-79",77,41,36,
"275",2011,"80-84",40,23,17,
"275",2011,"85-89",18,6,12,
"275",2011,"90+",17,6,11,
"282",2011,"0-4",36,15,21,
"282",2011,"5-9",38,20,18,
"282",2011,"10-14",42,17,25,
"282",2011,"15-19",55,31,24,
"282",2011,"20-24",33,17,16,
"282",2011,"25-29",35,24,11,
"282",2011,"30-34",31,13,18,
"282",2011,"35-39",39,23,16,
"282",2011,"40-44",46,25,21,
"282",2011,"45-49",43,26,17,
"282",2011,"50-54",57,38,19,
"282",2011,"55-59",59,37,22,
"282",2011,"60-64",48,27,21,
"282",2011,"65-69",33,15,18,
"282",2011,"70-74",24,18,6,
"282",2011,"75-79",7,0,7,
"282",2011,"80-84",11,1,10,
"282",2011,"85-89",4,0,4,
"282",2011,"90+",0,0,0,
"290",2011,"0-4",469,258,211,
"290",2011,"5-9",370,195,175,
"290",2011,"10-14",464,222,242,
"290",2011,"15-19",430,233,197,
"290",2011,"20-24",377,205,172,
"290",2011,"25-29",349,193,156,
"290",2011,"30-34",337,206,131,
"290",2011,"35-39",295,147,148,
"290",2011,"40-44",245,117,128,
"290",2011,"45-49",401,213,188,
"290",2011,"50-54",481,257,224,
"290",2011,"55-59",458,265,193,
"290",2011,"60-64",380,205,175,
"290",2011,"65-69",225,135,90,
"290",2011,"70-74",145,87,58,
"290",2011,"75-79",104,54,50,
"290",2011,"80-84",82,42,40,
"290",2011,"85-89",33,20,13,
"290",2011,"90+",10,4,6,
"000",2012,"0-4",54682,28142,26540,
"000",2012,"5-9",52686,26989,25697,
"000",2012,"10-14",51246,26317,24929,
"000",2012,"15-19",49708,26049,23659,
"000",2012,"20-24",55691,29953,25738,
"000",2012,"25-29",57760,30372,27388,
"000",2012,"30-34",52394,27230,25164,
"000",2012,"35-39",45326,23326,22000,
"000",2012,"40-44",46926,24407,22519,
"000",2012,"45-49",50225,25992,24233,
"000",2012,"50-54",56348,29218,27130,
"000",2012,"55-59",53391,27755,25636,
"000",2012,"60-64",40907,21638,19269,
"000",2012,"65-69",26338,13956,12382,
"000",2012,"70-74",15539,7918,7621,
"000",2012,"75-79",9803,4705,5098,
"000",2012,"80-84",6581,2915,3666,
"000",2012,"85-89",3630,1360,2270,
"000",2012,"90+",1824,583,1241,
"013",2012,"0-4",129,72,57,
"013",2012,"5-9",108,57,51,
"013",2012,"10-14",80,36,44,
"013",2012,"15-19",98,60,38,
"013",2012,"20-24",249,178,71,
"013",2012,"25-29",241,183,58,
"013",2012,"30-34",243,146,97,
"013",2012,"35-39",246,174,72,
"013",2012,"40-44",328,253,75,
"013",2012,"45-49",375,262,113,
"013",2012,"50-54",388,248,140,
"013",2012,"55-59",307,223,84,
"013",2012,"60-64",162,94,68,
"013",2012,"65-69",112,72,40,
"013",2012,"70-74",35,17,18,
"013",2012,"75-79",24,14,10,
"013",2012,"80-84",13,11,2,
"013",2012,"85-89",9,6,3,
"013",2012,"90+",1,1,0,
"016",2012,"0-4",186,99,87,
"016",2012,"5-9",207,113,94,
"016",2012,"10-14",216,121,95,
"016",2012,"15-19",237,138,99,
"016",2012,"20-24",310,217,93,
"016",2012,"25-29",529,405,124,
"016",2012,"30-34",489,345,144,
"016",2012,"35-39",508,359,149,
"016",2012,"40-44",544,383,161,
"016",2012,"45-49",581,392,189,
"016",2012,"50-54",661,464,197,
"016",2012,"55-59",492,331,161,
"016",2012,"60-64",374,260,114,
"016",2012,"65-69",178,112,66,
"016",2012,"70-74",57,40,17,
"016",2012,"75-79",17,10,7,
"016",2012,"80-84",12,7,5,
"016",2012,"85-89",12,2,10,
"016",2012,"90+",0,0,0,
"020",2012,"0-4",21935,11374,10561,
"020",2012,"5-9",20930,10686,10244,
"020",2012,"10-14",20569,10606,9963,
"020",2012,"15-19",20138,10342,9796,
"020",2012,"20-24",24826,13122,11704,
"020",2012,"25-29",25358,13076,12282,
"020",2012,"30-34",22605,11374,11231,
"020",2012,"35-39",18871,9459,9412,
"020",2012,"40-44",19770,9961,9809,
"020",2012,"45-49",20440,10153,10287,
"020",2012,"50-54",22189,11078,11111,
"020",2012,"55-59",20613,10343,10270,
"020",2012,"60-64",15438,7795,7643,
"020",2012,"65-69",10123,5191,4932,
"020",2012,"70-74",5736,2747,2989,
"020",2012,"75-79",3816,1719,2097,
"020",2012,"80-84",2706,1133,1573,
"020",2012,"85-89",1427,506,921,
"020",2012,"90+",816,267,549,
"050",2012,"0-4",1816,928,888,
"050",2012,"5-9",1791,911,880,
"050",2012,"10-14",1719,890,829,
"050",2012,"15-19",1570,815,755,
"050",2012,"20-24",1442,699,743,
"050",2012,"25-29",1387,725,662,
"050",2012,"30-34",1112,556,556,
"050",2012,"35-39",885,435,450,
"050",2012,"40-44",934,488,446,
"050",2012,"45-49",1134,654,480,
"050",2012,"50-54",1067,606,461,
"050",2012,"55-59",929,495,434,
"050",2012,"60-64",677,351,326,
"050",2012,"65-69",436,234,202,
"050",2012,"70-74",264,129,135,
"050",2012,"75-79",204,93,111,
"050",2012,"80-84",120,51,69,
"050",2012,"85-89",50,24,26,
"050",2012,"90+",18,7,11,
"060",2012,"0-4",46,29,17,
"060",2012,"5-9",47,26,21,
"060",2012,"10-14",65,31,34,
"060",2012,"15-19",73,33,40,
"060",2012,"20-24",43,24,19,
"060",2012,"25-29",88,48,40,
"060",2012,"30-34",37,20,17,
"060",2012,"35-39",56,30,26,
"060",2012,"40-44",76,46,30,
"060",2012,"45-49",87,48,39,
"060",2012,"50-54",106,57,49,
"060",2012,"55-59",102,59,43,
"060",2012,"60-64",74,47,27,
"060",2012,"65-69",28,18,10,
"060",2012,"70-74",25,16,9,
"060",2012,"75-79",17,6,11,
"060",2012,"80-84",9,7,2,
"060",2012,"85-89",3,0,3,
"060",2012,"90+",2,0,2,
"063",2012,"0-4",494,229,265,
"063",2012,"5-9",439,221,218,
"063",2012,"10-14",446,216,230,
"063",2012,"15-19",442,247,195,
"063",2012,"20-24",375,206,169,
"063",2012,"25-29",550,303,247,
"063",2012,"30-34",448,243,205,
"063",2012,"35-39",445,247,198,
"063",2012,"40-44",459,238,221,
"063",2012,"45-49",522,281,241,
"063",2012,"50-54",676,380,296,
"063",2012,"55-59",630,322,308,
"063",2012,"60-64",437,248,189,
"063",2012,"65-69",265,139,126,
"063",2012,"70-74",121,54,67,
"063",2012,"75-79",80,48,32,
"063",2012,"80-84",42,15,27,
"063",2012,"85-89",25,10,15,
"063",2012,"90+",11,3,8,
"066",2012,"0-4",195,107,88,
"066",2012,"5-9",205,106,99,
"066",2012,"10-14",235,107,128,
"066",2012,"15-19",204,97,107,
"066",2012,"20-24",147,75,72,
"066",2012,"25-29",151,87,64,
"066",2012,"30-34",174,91,83,
"066",2012,"35-39",148,68,80,
"066",2012,"40-44",161,92,69,
"066",2012,"45-49",202,99,103,
"066",2012,"50-54",294,153,141,
"066",2012,"55-59",281,155,126,
"066",2012,"60-64",287,177,110,
"066",2012,"65-69",138,83,55,
"066",2012,"70-74",102,52,50,
"066",2012,"75-79",55,37,18,
"066",2012,"80-84",26,15,11,
"066",2012,"85-89",18,4,14,
"066",2012,"90+",11,5,6,
"068",2012,"0-4",114,64,50,
"068",2012,"5-9",111,73,38,
"068",2012,"10-14",132,59,73,
"068",2012,"15-19",92,39,53,
"068",2012,"20-24",46,26,20,
"068",2012,"25-29",97,46,51,
"068",2012,"30-34",144,72,72,
"068",2012,"35-39",114,51,63,
"068",2012,"40-44",147,82,65,
"068",2012,"45-49",168,94,74,
"068",2012,"50-54",171,109,62,
"068",2012,"55-59",189,109,80,
"068",2012,"60-64",166,114,52,
"068",2012,"65-69",64,35,29,
"068",2012,"70-74",57,35,22,
"068",2012,"75-79",25,17,8,
"068",2012,"80-84",9,3,6,
"068",2012,"85-89",2,2,0,
"068",2012,"90+",1,1,0,
"070",2012,"0-4",498,256,242,
"070",2012,"5-9",433,231,202,
"070",2012,"10-14",412,217,195,
"070",2012,"15-19",442,229,213,
"070",2012,"20-24",406,212,194,
"070",2012,"25-29",344,180,164,
"070",2012,"30-34",290,142,148,
"070",2012,"35-39",243,133,110,
"070",2012,"40-44",231,127,104,
"070",2012,"45-49",352,165,187,
"070",2012,"50-54",357,195,162,
"070",2012,"55-59",343,181,162,
"070",2012,"60-64",248,137,111,
"070",2012,"65-69",135,68,67,
"070",2012,"70-74",114,58,56,
"070",2012,"75-79",63,37,26,
"070",2012,"80-84",43,22,21,
"070",2012,"85-89",19,7,12,
"070",2012,"90+",6,3,3,
"090",2012,"0-4",8065,4175,3890,
"090",2012,"5-9",7341,3714,3627,
"090",2012,"10-14",6474,3373,3101,
"090",2012,"15-19",6368,3374,2994,
"090",2012,"20-24",9870,5524,4346,
"090",2012,"25-29",9407,5089,4318,
"090",2012,"30-34",8031,4357,3674,
"090",2012,"35-39",6543,3329,3214,
"090",2012,"40-44",6155,3281,2874,
"090",2012,"45-49",6135,3112,3023,
"090",2012,"50-54",6978,3557,3421,
"090",2012,"55-59",6621,3364,3257,
"090",2012,"60-64",5158,2798,2360,
"090",2012,"65-69",3228,1763,1465,
"090",2012,"70-74",1859,940,919,
"090",2012,"75-79",1051,544,507,
"090",2012,"80-84",775,344,431,
"090",2012,"85-89",436,165,271,
"090",2012,"90+",200,60,140,
"100",2012,"0-4",134,72,62,
"100",2012,"5-9",151,65,86,
"100",2012,"10-14",141,81,60,
"100",2012,"15-19",131,65,66,
"100",2012,"20-24",99,60,39,
"100",2012,"25-29",118,59,59,
"100",2012,"30-34",151,72,79,
"100",2012,"35-39",145,68,77,
"100",2012,"40-44",175,86,89,
"100",2012,"45-49",191,104,87,
"100",2012,"50-54",229,115,114,
"100",2012,"55-59",287,149,138,
"100",2012,"60-64",251,130,121,
"100",2012,"65-69",179,83,96,
"100",2012,"70-74",81,41,40,
"100",2012,"75-79",61,24,37,
"100",2012,"80-84",50,23,27,
"100",2012,"85-89",26,11,15,
"100",2012,"90+",13,3,10,
"105",2012,"0-4",147,83,64,
"105",2012,"5-9",109,51,58,
"105",2012,"10-14",123,53,70,
"105",2012,"15-19",104,56,48,
"105",2012,"20-24",100,55,45,
"105",2012,"25-29",122,71,51,
"105",2012,"30-34",122,58,64,
"105",2012,"35-39",116,60,56,
"105",2012,"40-44",122,72,50,
"105",2012,"45-49",149,75,74,
"105",2012,"50-54",206,109,97,
"105",2012,"55-59",224,123,101,
"105",2012,"60-64",228,124,104,
"105",2012,"65-69",151,94,57,
"105",2012,"70-74",83,51,32,
"105",2012,"75-79",55,39,16,
"105",2012,"80-84",22,15,7,
"105",2012,"85-89",12,4,8,
"105",2012,"90+",5,3,2,
"110",2012,"0-4",2038,1026,1012,
"110",2012,"5-9",2072,1041,1031,
"110",2012,"10-14",2069,1081,988,
"110",2012,"15-19",2128,1122,1006,
"110",2012,"20-24",2046,1043,1003,
"110",2012,"25-29",2532,1259,1273,
"110",2012,"30-34",2286,1205,1081,
"110",2012,"35-39",2062,1046,1016,
"110",2012,"40-44",2272,1157,1115,
"110",2012,"45-49",2458,1251,1207,
"110",2012,"50-54",2873,1491,1382,
"110",2012,"55-59",2661,1321,1340,
"110",2012,"60-64",2119,1122,997,
"110",2012,"65-69",1279,657,622,
"110",2012,"70-74",759,378,381,
"110",2012,"75-79",438,186,252,
"110",2012,"80-84",303,126,177,
"110",2012,"85-89",187,70,117,
"110",2012,"90+",94,27,67,
"122",2012,"0-4",3512,1766,1746,
"122",2012,"5-9",3491,1788,1703,
"122",2012,"10-14",3705,1798,1907,
"122",2012,"15-19",3680,1969,1711,
"122",2012,"20-24",3135,1769,1366,
"122",2012,"25-29",3380,1851,1529,
"122",2012,"30-34",3263,1689,1574,
"122",2012,"35-39",3192,1684,1508,
"122",2012,"40-44",3513,1862,1651,
"122",2012,"45-49",3888,1987,1901,
"122",2012,"50-54",4936,2523,2413,
"122",2012,"55-59",5316,2686,2630,
"122",2012,"60-64",4309,2324,1985,
"122",2012,"65-69",3002,1649,1353,
"122",2012,"70-74",1816,974,842,
"122",2012,"75-79",1166,588,578,
"122",2012,"80-84",697,338,359,
"122",2012,"85-89",409,170,239,
"122",2012,"90+",214,70,144,
"130",2012,"0-4",930,437,493,
"130",2012,"5-9",848,449,399,
"130",2012,"10-14",870,455,415,
"130",2012,"15-19",883,470,413,
"130",2012,"20-24",910,487,423,
"130",2012,"25-29",957,498,459,
"130",2012,"30-34",938,477,461,
"130",2012,"35-39",811,397,414,
"130",2012,"40-44",893,449,444,
"130",2012,"45-49",975,489,486,
"130",2012,"50-54",1182,642,540,
"130",2012,"55-59",1179,592,587,
"130",2012,"60-64",944,501,443,
"130",2012,"65-69",619,310,309,
"130",2012,"70-74",381,198,183,
"130",2012,"75-79",232,117,115,
"130",2012,"80-84",175,79,96,
"130",2012,"85-89",103,40,63,
"130",2012,"90+",63,18,45,
"150",2012,"0-4",1142,592,550,
"150",2012,"5-9",1018,524,494,
"150",2012,"10-14",1043,556,487,
"150",2012,"15-19",1000,530,470,
"150",2012,"20-24",1043,590,453,
"150",2012,"25-29",1129,618,511,
"150",2012,"30-34",1068,567,501,
"150",2012,"35-39",842,452,390,
"150",2012,"40-44",839,432,407,
"150",2012,"45-49",985,501,484,
"150",2012,"50-54",1089,589,500,
"150",2012,"55-59",993,553,440,
"150",2012,"60-64",698,366,332,
"150",2012,"65-69",470,234,236,
"150",2012,"70-74",293,154,139,
"150",2012,"75-79",155,77,78,
"150",2012,"80-84",91,33,58,
"150",2012,"85-89",51,24,27,
"150",2012,"90+",32,13,19,
"158",2012,"0-4",911,487,424,
"158",2012,"5-9",884,460,424,
"158",2012,"10-14",838,424,414,
"158",2012,"15-19",803,406,397,
"158",2012,"20-24",772,408,364,
"158",2012,"25-29",608,308,300,
"158",2012,"30-34",364,192,172,
"158",2012,"35-39",376,208,168,
"158",2012,"40-44",363,177,186,
"158",2012,"45-49",411,216,195,
"158",2012,"50-54",391,206,185,
"158",2012,"55-59",314,179,135,
"158",2012,"60-64",232,123,109,
"158",2012,"65-69",156,84,72,
"158",2012,"70-74",95,46,49,
"158",2012,"75-79",82,33,49,
"158",2012,"80-84",38,18,20,
"158",2012,"85-89",29,8,21,
"158",2012,"90+",8,2,6,
"164",2012,"0-4",144,74,70,
"164",2012,"5-9",137,75,62,
"164",2012,"10-14",118,51,67,
"164",2012,"15-19",132,77,55,
"164",2012,"20-24",136,63,73,
"164",2012,"25-29",137,73,64,
"164",2012,"30-34",118,67,51,
"164",2012,"35-39",97,49,48,
"164",2012,"40-44",56,35,21,
"164",2012,"45-49",118,62,56,
"164",2012,"50-54",150,86,64,
"164",2012,"55-59",114,68,46,
"164",2012,"60-64",86,40,46,
"164",2012,"65-69",57,32,25,
"164",2012,"70-74",38,17,21,
"164",2012,"75-79",15,11,4,
"164",2012,"80-84",17,11,6,
"164",2012,"85-89",8,2,6,
"164",2012,"90+",1,0,1,
"170",2012,"0-4",7004,3625,3379,
"170",2012,"5-9",7674,3934,3740,
"170",2012,"10-14",7350,3745,3605,
"170",2012,"15-19",7047,3750,3297,
"170",2012,"20-24",5381,2856,2525,
"170",2012,"25-29",6148,3081,3067,
"170",2012,"30-34",6285,3198,3087,
"170",2012,"35-39",5949,3021,2928,
"170",2012,"40-44",6387,3297,3090,
"170",2012,"45-49",6571,3414,3157,
"170",2012,"50-54",7504,3854,3650,
"170",2012,"55-59",6821,3607,3214,
"170",2012,"60-64",5270,2720,2550,
"170",2012,"65-69",3373,1748,1625,
"170",2012,"70-74",2159,1161,998,
"170",2012,"75-79",1281,635,646,
"170",2012,"80-84",830,405,425,
"170",2012,"85-89",460,169,291,
"170",2012,"90+",170,50,120,
"180",2012,"0-4",1085,578,507,
"180",2012,"5-9",937,479,458,
"180",2012,"10-14",893,466,427,
"180",2012,"15-19",773,428,345,
"180",2012,"20-24",823,421,402,
"180",2012,"25-29",801,440,361,
"180",2012,"30-34",615,325,290,
"180",2012,"35-39",568,302,266,
"180",2012,"40-44",515,270,245,
"180",2012,"45-49",594,329,265,
"180",2012,"50-54",611,338,273,
"180",2012,"55-59",559,297,262,
"180",2012,"60-64",437,241,196,
"180",2012,"65-69",266,155,111,
"180",2012,"70-74",150,93,57,
"180",2012,"75-79",112,46,66,
"180",2012,"80-84",63,27,36,
"180",2012,"85-89",32,17,15,
"180",2012,"90+",13,3,10,
"185",2012,"0-4",764,385,379,
"185",2012,"5-9",694,368,326,
"185",2012,"10-14",596,310,286,
"185",2012,"15-19",542,289,253,
"185",2012,"20-24",800,476,324,
"185",2012,"25-29",839,513,326,
"185",2012,"30-34",764,495,269,
"185",2012,"35-39",574,401,173,
"185",2012,"40-44",540,357,183,
"185",2012,"45-49",864,608,256,
"185",2012,"50-54",899,598,301,
"185",2012,"55-59",915,685,230,
"185",2012,"60-64",494,331,163,
"185",2012,"65-69",216,150,66,
"185",2012,"70-74",87,45,42,
"185",2012,"75-79",58,24,34,
"185",2012,"80-84",40,16,24,
"185",2012,"85-89",19,8,11,
"185",2012,"90+",5,2,3,
"188",2012,"0-4",887,468,419,
"188",2012,"5-9",750,375,375,
"188",2012,"10-14",705,356,349,
"188",2012,"15-19",597,300,297,
"188",2012,"20-24",768,421,347,
"188",2012,"25-29",617,331,286,
"188",2012,"30-34",503,271,232,
"188",2012,"35-39",402,226,176,
"188",2012,"40-44",369,211,158,
"188",2012,"45-49",473,282,191,
"188",2012,"50-54",466,266,200,
"188",2012,"55-59",405,239,166,
"188",2012,"60-64",278,165,113,
"188",2012,"65-69",181,86,95,
"188",2012,"70-74",123,68,55,
"188",2012,"75-79",88,36,52,
"188",2012,"80-84",59,22,37,
"188",2012,"85-89",34,12,22,
"188",2012,"90+",7,1,6,
"195",2012,"0-4",215,105,110,
"195",2012,"5-9",167,83,84,
"195",2012,"10-14",239,128,111,
"195",2012,"15-19",191,98,93,
"195",2012,"20-24",151,70,81,
"195",2012,"25-29",203,97,106,
"195",2012,"30-34",193,100,93,
"195",2012,"35-39",177,92,85,
"195",2012,"40-44",207,99,108,
"195",2012,"45-49",238,125,113,
"195",2012,"50-54",252,122,130,
"195",2012,"55-59",317,167,150,
"195",2012,"60-64",261,143,118,
"195",2012,"65-69",194,119,75,
"195",2012,"70-74",104,57,47,
"195",2012,"75-79",47,30,17,
"195",2012,"80-84",41,14,27,
"195",2012,"85-89",34,16,18,
"195",2012,"90+",13,6,7,
"198",2012,"0-4",481,217,264,
"198",2012,"5-9",439,240,199,
"198",2012,"10-14",434,240,194,
"198",2012,"15-19",397,234,163,
"198",2012,"20-24",364,215,149,
"198",2012,"25-29",339,171,168,
"198",2012,"30-34",377,202,175,
"198",2012,"35-39",372,188,184,
"198",2012,"40-44",407,202,205,
"198",2012,"45-49",516,303,213,
"198",2012,"50-54",548,289,259,
"198",2012,"55-59",572,313,259,
"198",2012,"60-64",469,284,185,
"198",2012,"65-69",335,199,136,
"198",2012,"70-74",196,117,79,
"198",2012,"75-79",125,79,46,
"198",2012,"80-84",60,22,38,
"198",2012,"85-89",21,12,9,
"198",2012,"90+",10,8,2,
"220",2012,"0-4",607,297,310,
"220",2012,"5-9",573,304,269,
"220",2012,"10-14",552,293,259,
"220",2012,"15-19",531,280,251,
"220",2012,"20-24",509,251,258,
"220",2012,"25-29",640,278,362,
"220",2012,"30-34",657,344,313,
"220",2012,"35-39",602,325,277,
"220",2012,"40-44",553,275,278,
"220",2012,"45-49",577,303,274,
"220",2012,"50-54",749,378,371,
"220",2012,"55-59",739,367,372,
"220",2012,"60-64",609,318,291,
"220",2012,"65-69",378,193,185,
"220",2012,"70-74",289,142,147,
"220",2012,"75-79",204,83,121,
"220",2012,"80-84",128,56,72,
"220",2012,"85-89",102,26,76,
"220",2012,"90+",64,13,51,
"230",2012,"0-4",62,26,36,
"230",2012,"5-9",29,15,14,
"230",2012,"10-14",32,15,17,
"230",2012,"15-19",30,16,14,
"230",2012,"20-24",36,17,19,
"230",2012,"25-29",77,41,36,
"230",2012,"30-34",95,52,43,
"230",2012,"35-39",63,33,30,
"230",2012,"40-44",88,44,44,
"230",2012,"45-49",79,41,38,
"230",2012,"50-54",74,39,35,
"230",2012,"55-59",100,62,38,
"230",2012,"60-64",78,47,31,
"230",2012,"65-69",49,19,30,
"230",2012,"70-74",32,18,14,
"230",2012,"75-79",17,3,14,
"230",2012,"80-84",10,2,8,
"230",2012,"85-89",3,2,1,
"230",2012,"90+",3,1,2,
"240",2012,"0-4",499,241,258,
"240",2012,"5-9",536,298,238,
"240",2012,"10-14",545,298,247,
"240",2012,"15-19",468,245,223,
"240",2012,"20-24",411,207,204,
"240",2012,"25-29",408,240,168,
"240",2012,"30-34",545,287,258,
"240",2012,"35-39",455,262,193,
"240",2012,"40-44",415,235,180,
"240",2012,"45-49",547,317,230,
"240",2012,"50-54",567,335,232,
"240",2012,"55-59",598,321,277,
"240",2012,"60-64",462,281,181,
"240",2012,"65-69",292,185,107,
"240",2012,"70-74",217,118,99,
"240",2012,"75-79",116,65,51,
"240",2012,"80-84",63,31,32,
"240",2012,"85-89",38,11,27,
"240",2012,"90+",18,4,14,
"275",2012,"0-4",135,60,75,
"275",2012,"5-9",143,66,77,
"275",2012,"10-14",155,82,73,
"275",2012,"15-19",154,89,65,
"275",2012,"20-24",108,53,55,
"275",2012,"25-29",145,74,71,
"275",2012,"30-34",101,58,43,
"275",2012,"35-39",101,46,55,
"275",2012,"40-44",120,58,62,
"275",2012,"45-49",173,96,77,
"275",2012,"50-54",227,114,113,
"275",2012,"55-59",259,143,116,
"275",2012,"60-64",210,114,96,
"275",2012,"65-69",153,79,74,
"275",2012,"70-74",104,58,46,
"275",2012,"75-79",82,45,37,
"275",2012,"80-84",41,22,19,
"275",2012,"85-89",17,6,11,
"275",2012,"90+",16,8,8,
"282",2012,"0-4",32,13,19,
"282",2012,"5-9",30,14,16,
"282",2012,"10-14",45,16,29,
"282",2012,"15-19",45,27,18,
"282",2012,"20-24",32,17,15,
"282",2012,"25-29",32,18,14,
"282",2012,"30-34",33,19,14,
"282",2012,"35-39",43,24,19,
"282",2012,"40-44",43,24,19,
"282",2012,"45-49",46,26,20,
"282",2012,"50-54",55,36,19,
"282",2012,"55-59",53,33,20,
"282",2012,"60-64",54,30,24,
"282",2012,"65-69",32,17,15,
"282",2012,"70-74",22,17,5,
"282",2012,"75-79",9,1,8,
"282",2012,"80-84",10,1,9,
"282",2012,"85-89",5,1,4,
"282",2012,"90+",0,0,0,
"290",2012,"0-4",475,257,218,
"290",2012,"5-9",392,222,170,
"290",2012,"10-14",445,213,232,
"290",2012,"15-19",408,224,184,
"290",2012,"20-24",353,191,162,
"290",2012,"25-29",376,209,167,
"290",2012,"30-34",343,206,137,
"290",2012,"35-39",320,157,163,
"290",2012,"40-44",244,114,130,
"290",2012,"45-49",376,203,173,
"290",2012,"50-54",453,241,212,
"290",2012,"55-59",458,268,190,
"290",2012,"60-64",397,213,184,
"290",2012,"65-69",249,148,101,
"290",2012,"70-74",140,77,63,
"290",2012,"75-79",108,58,50,
"290",2012,"80-84",88,46,42,
"290",2012,"85-89",39,25,14,
"290",2012,"90+",9,4,5,
"000",2013,"0-4",54240,27980,26260,
"000",2013,"5-9",53850,27621,26229,
"000",2013,"10-14",51821,26705,25116,
"000",2013,"15-19",49050,25595,23455,
"000",2013,"20-24",54934,29497,25437,
"000",2013,"25-29",57186,29785,27401,
"000",2013,"30-34",54284,28103,26181,
"000",2013,"35-39",45850,23663,22187,
"000",2013,"40-44",46510,23932,22578,
"000",2013,"45-49",47909,24714,23195,
"000",2013,"50-54",56007,29014,26993,
"000",2013,"55-59",54102,27868,26234,
"000",2013,"60-64",43039,22787,20252,
"000",2013,"65-69",28053,14813,13240,
"000",2013,"70-74",16918,8653,8265,
"000",2013,"75-79",10393,5055,5338,
"000",2013,"80-84",6764,2994,3770,
"000",2013,"85-89",3699,1403,2296,
"000",2013,"90+",1943,645,1298,
"013",2013,"0-4",107,56,51,
"013",2013,"5-9",98,49,49,
"013",2013,"10-14",91,42,49,
"013",2013,"15-19",113,69,44,
"013",2013,"20-24",238,172,66,
"013",2013,"25-29",206,151,55,
"013",2013,"30-34",269,178,91,
"013",2013,"35-39",286,211,75,
"013",2013,"40-44",253,187,66,
"013",2013,"45-49",353,236,117,
"013",2013,"50-54",408,266,142,
"013",2013,"55-59",318,212,106,
"013",2013,"60-64",188,110,78,
"013",2013,"65-69",122,77,45,
"013",2013,"70-74",44,25,19,
"013",2013,"75-79",31,20,11,
"013",2013,"80-84",14,12,2,
"013",2013,"85-89",11,8,3,
"013",2013,"90+",1,1,0,
"016",2013,"0-4",192,101,91,
"016",2013,"5-9",240,124,116,
"016",2013,"10-14",205,116,89,
"016",2013,"15-19",260,157,103,
"016",2013,"20-24",302,196,106,
"016",2013,"25-29",474,357,117,
"016",2013,"30-34",501,338,163,
"016",2013,"35-39",517,358,159,
"016",2013,"40-44",480,334,146,
"016",2013,"45-49",567,388,179,
"016",2013,"50-54",660,433,227,
"016",2013,"55-59",510,359,151,
"016",2013,"60-64",401,267,134,
"016",2013,"65-69",212,139,73,
"016",2013,"70-74",63,43,20,
"016",2013,"75-79",16,9,7,
"016",2013,"80-84",11,7,4,
"016",2013,"85-89",13,3,10,
"016",2013,"90+",0,0,0,
"020",2013,"0-4",21913,11448,10465,
"020",2013,"5-9",21436,10973,10463,
"020",2013,"10-14",20746,10739,10007,
"020",2013,"15-19",19848,10094,9754,
"020",2013,"20-24",24723,12995,11728,
"020",2013,"25-29",25439,13046,12393,
"020",2013,"30-34",23646,11896,11750,
"020",2013,"35-39",19111,9589,9522,
"020",2013,"40-44",19526,9764,9762,
"020",2013,"45-49",19540,9701,9839,
"020",2013,"50-54",22220,11087,11133,
"020",2013,"55-59",20779,10315,10464,
"020",2013,"60-64",16122,8212,7910,
"020",2013,"65-69",10771,5479,5292,
"020",2013,"70-74",6245,3026,3219,
"020",2013,"75-79",4074,1851,2223,
"020",2013,"80-84",2753,1162,1591,
"020",2013,"85-89",1451,525,926,
"020",2013,"90+",880,289,591,
"050",2013,"0-4",1875,959,916,
"050",2013,"5-9",1837,922,915,
"050",2013,"10-14",1736,922,814,
"050",2013,"15-19",1585,818,767,
"050",2013,"20-24",1476,722,754,
"050",2013,"25-29",1442,743,699,
"050",2013,"30-34",1166,583,583,
"050",2013,"35-39",889,441,448,
"050",2013,"40-44",911,449,462,
"050",2013,"45-49",1069,615,454,
"050",2013,"50-54",1106,627,479,
"050",2013,"55-59",988,521,467,
"050",2013,"60-64",721,380,341,
"050",2013,"65-69",433,234,199,
"050",2013,"70-74",275,135,140,
"050",2013,"75-79",199,105,94,
"050",2013,"80-84",130,49,81,
"050",2013,"85-89",47,22,25,
"050",2013,"90+",16,6,10,
"060",2013,"0-4",43,25,18,
"060",2013,"5-9",45,25,20,
"060",2013,"10-14",57,26,31,
"060",2013,"15-19",73,35,38,
"060",2013,"20-24",36,23,13,
"060",2013,"25-29",81,45,36,
"060",2013,"30-34",40,20,20,
"060",2013,"35-39",56,26,30,
"060",2013,"40-44",62,41,21,
"060",2013,"45-49",77,43,34,
"060",2013,"50-54",100,54,46,
"060",2013,"55-59",99,61,38,
"060",2013,"60-64",76,40,36,
"060",2013,"65-69",28,18,10,
"060",2013,"70-74",23,15,8,
"060",2013,"75-79",24,9,15,
"060",2013,"80-84",9,7,2,
"060",2013,"85-89",3,0,3,
"060",2013,"90+",1,0,1,
"063",2013,"0-4",468,218,250,
"063",2013,"5-9",448,232,216,
"063",2013,"10-14",435,212,223,
"063",2013,"15-19",429,225,204,
"063",2013,"20-24",359,196,163,
"063",2013,"25-29",567,319,248,
"063",2013,"30-34",481,258,223,
"063",2013,"35-39",403,220,183,
"063",2013,"40-44",454,245,209,
"063",2013,"45-49",484,245,239,
"063",2013,"50-54",680,381,299,
"063",2013,"55-59",617,314,303,
"063",2013,"60-64",440,243,197,
"063",2013,"65-69",297,157,140,
"063",2013,"70-74",136,64,72,
"063",2013,"75-79",76,44,32,
"063",2013,"80-84",46,17,29,
"063",2013,"85-89",20,10,10,
"063",2013,"90+",9,1,8,
"066",2013,"0-4",174,94,80,
"066",2013,"5-9",205,111,94,
"066",2013,"10-14",250,115,135,
"066",2013,"15-19",190,91,99,
"066",2013,"20-24",124,69,55,
"066",2013,"25-29",141,74,67,
"066",2013,"30-34",176,80,96,
"066",2013,"35-39",162,78,84,
"066",2013,"40-44",146,84,62,
"066",2013,"45-49",200,106,94,
"066",2013,"50-54",278,146,132,
"066",2013,"55-59",290,160,130,
"066",2013,"60-64",269,166,103,
"066",2013,"65-69",156,91,65,
"066",2013,"70-74",98,54,44,
"066",2013,"75-79",58,34,24,
"066",2013,"80-84",23,13,10,
"066",2013,"85-89",18,4,14,
"066",2013,"90+",9,3,6,
"068",2013,"0-4",104,59,45,
"068",2013,"5-9",104,61,43,
"068",2013,"10-14",108,48,60,
"068",2013,"15-19",89,42,47,
"068",2013,"20-24",47,23,24,
"068",2013,"25-29",78,35,43,
"068",2013,"30-34",143,70,73,
"068",2013,"35-39",128,61,67,
"068",2013,"40-44",137,79,58,
"068",2013,"45-49",163,81,82,
"068",2013,"50-54",167,105,62,
"068",2013,"55-59",165,90,75,
"068",2013,"60-64",186,126,60,
"068",2013,"65-69",66,38,28,
"068",2013,"70-74",51,33,18,
"068",2013,"75-79",25,13,12,
"068",2013,"80-84",18,12,6,
"068",2013,"85-89",2,2,0,
"068",2013,"90+",0,0,0,
"070",2013,"0-4",495,240,255,
"070",2013,"5-9",441,238,203,
"070",2013,"10-14",416,218,198,
"070",2013,"15-19",433,223,210,
"070",2013,"20-24",392,199,193,
"070",2013,"25-29",381,200,181,
"070",2013,"30-34",295,154,141,
"070",2013,"35-39",251,126,125,
"070",2013,"40-44",234,122,112,
"070",2013,"45-49",302,142,160,
"070",2013,"50-54",351,187,164,
"070",2013,"55-59",362,193,169,
"070",2013,"60-64",279,149,130,
"070",2013,"65-69",136,70,66,
"070",2013,"70-74",125,60,65,
"070",2013,"75-79",55,34,21,
"070",2013,"80-84",55,29,26,
"070",2013,"85-89",18,7,11,
"070",2013,"90+",8,5,3,
"090",2013,"0-4",7563,3898,3665,
"090",2013,"5-9",7305,3766,3539,
"090",2013,"10-14",6597,3429,3168,
"090",2013,"15-19",6209,3295,2914,
"090",2013,"20-24",9584,5467,4117,
"090",2013,"25-29",8964,4811,4153,
"090",2013,"30-34",8112,4363,3749,
"090",2013,"35-39",6509,3346,3163,
"090",2013,"40-44",6176,3276,2900,
"090",2013,"45-49",5835,2907,2928,
"090",2013,"50-54",6875,3509,3366,
"090",2013,"55-59",6769,3407,3362,
"090",2013,"60-64",5507,3021,2486,
"090",2013,"65-69",3462,1865,1597,
"090",2013,"70-74",2082,1057,1025,
"090",2013,"75-79",1116,586,530,
"090",2013,"80-84",756,336,420,
"090",2013,"85-89",467,176,291,
"090",2013,"90+",206,60,146,
"100",2013,"0-4",115,62,53,
"100",2013,"5-9",143,66,77,
"100",2013,"10-14",130,74,56,
"100",2013,"15-19",134,65,69,
"100",2013,"20-24",73,44,29,
"100",2013,"25-29",126,65,61,
"100",2013,"30-34",142,61,81,
"100",2013,"35-39",141,73,68,
"100",2013,"40-44",159,75,84,
"100",2013,"45-49",171,90,81,
"100",2013,"50-54",237,118,119,
"100",2013,"55-59",273,139,134,
"100",2013,"60-64",255,127,128,
"100",2013,"65-69",183,95,88,
"100",2013,"70-74",93,44,49,
"100",2013,"75-79",60,23,37,
"100",2013,"80-84",55,21,34,
"100",2013,"85-89",23,13,10,
"100",2013,"90+",19,8,11,
"105",2013,"0-4",144,84,60,
"105",2013,"5-9",122,62,60,
"105",2013,"10-14",115,39,76,
"105",2013,"15-19",102,54,48,
"105",2013,"20-24",81,49,32,
"105",2013,"25-29",124,68,56,
"105",2013,"30-34",113,57,56,
"105",2013,"35-39",123,55,68,
"105",2013,"40-44",116,72,44,
"105",2013,"45-49",137,71,66,
"105",2013,"50-54",218,111,107,
"105",2013,"55-59",211,114,97,
"105",2013,"60-64",239,125,114,
"105",2013,"65-69",141,96,45,
"105",2013,"70-74",94,52,42,
"105",2013,"75-79",65,43,22,
"105",2013,"80-84",22,14,8,
"105",2013,"85-89",10,2,8,
"105",2013,"90+",6,4,2,
"110",2013,"0-4",2014,1037,977,
"110",2013,"5-9",2122,1050,1072,
"110",2013,"10-14",2072,1071,1001,
"110",2013,"15-19",2022,1078,944,
"110",2013,"20-24",2073,1043,1030,
"110",2013,"25-29",2530,1276,1254,
"110",2013,"30-34",2441,1270,1171,
"110",2013,"35-39",2090,1053,1037,
"110",2013,"40-44",2225,1127,1098,
"110",2013,"45-49",2375,1206,1169,
"110",2013,"50-54",2902,1515,1387,
"110",2013,"55-59",2650,1343,1307,
"110",2013,"60-64",2197,1118,1079,
"110",2013,"65-69",1401,732,669,
"110",2013,"70-74",810,395,415,
"110",2013,"75-79",471,205,266,
"110",2013,"80-84",289,121,168,
"110",2013,"85-89",188,72,116,
"110",2013,"90+",91,26,65,
"122",2013,"0-4",3573,1795,1778,
"122",2013,"5-9",3546,1774,1772,
"122",2013,"10-14",3726,1832,1894,
"122",2013,"15-19",3677,1946,1731,
"122",2013,"20-24",2997,1667,1330,
"122",2013,"25-29",3274,1772,1502,
"122",2013,"30-34",3393,1748,1645,
"122",2013,"35-39",3263,1736,1527,
"122",2013,"40-44",3488,1854,1634,
"122",2013,"45-49",3675,1853,1822,
"122",2013,"50-54",4732,2434,2298,
"122",2013,"55-59",5255,2620,2635,
"122",2013,"60-64",4533,2437,2096,
"122",2013,"65-69",3117,1708,1409,
"122",2013,"70-74",2076,1101,975,
"122",2013,"75-79",1187,605,582,
"122",2013,"80-84",723,353,370,
"122",2013,"85-89",437,178,259,
"122",2013,"90+",237,85,152,
"130",2013,"0-4",870,423,447,
"130",2013,"5-9",882,470,412,
"130",2013,"10-14",887,465,422,
"130",2013,"15-19",891,458,433,
"130",2013,"20-24",857,462,395,
"130",2013,"25-29",905,473,432,
"130",2013,"30-34",903,474,429,
"130",2013,"35-39",823,392,431,
"130",2013,"40-44",839,403,436,
"130",2013,"45-49",941,474,467,
"130",2013,"50-54",1176,630,546,
"130",2013,"55-59",1210,613,597,
"130",2013,"60-64",955,481,474,
"130",2013,"65-69",677,339,338,
"130",2013,"70-74",433,229,204,
"130",2013,"75-79",258,140,118,
"130",2013,"80-84",169,72,97,
"130",2013,"85-89",100,48,52,
"130",2013,"90+",71,22,49,
"150",2013,"0-4",1117,566,551,
"150",2013,"5-9",981,497,484,
"150",2013,"10-14",1051,548,503,
"150",2013,"15-19",957,505,452,
"150",2013,"20-24",988,555,433,
"150",2013,"25-29",1111,605,506,
"150",2013,"30-34",1054,540,514,
"150",2013,"35-39",856,444,412,
"150",2013,"40-44",809,410,399,
"150",2013,"45-49",935,490,445,
"150",2013,"50-54",1030,554,476,
"150",2013,"55-59",1079,584,495,
"150",2013,"60-64",723,392,331,
"150",2013,"65-69",505,250,255,
"150",2013,"70-74",290,150,140,
"150",2013,"75-79",162,81,81,
"150",2013,"80-84",98,40,58,
"150",2013,"85-89",50,16,34,
"150",2013,"90+",27,12,15,
"158",2013,"0-4",954,519,435,
"158",2013,"5-9",885,466,419,
"158",2013,"10-14",870,439,431,
"158",2013,"15-19",789,407,382,
"158",2013,"20-24",821,434,387,
"158",2013,"25-29",638,327,311,
"158",2013,"30-34",424,228,196,
"158",2013,"35-39",381,208,173,
"158",2013,"40-44",367,176,191,
"158",2013,"45-49",416,222,194,
"158",2013,"50-54",398,214,184,
"158",2013,"55-59",332,192,140,
"158",2013,"60-64",245,131,114,
"158",2013,"65-69",185,103,82,
"158",2013,"70-74",90,44,46,
"158",2013,"75-79",83,33,50,
"158",2013,"80-84",49,20,29,
"158",2013,"85-89",16,4,12,
"158",2013,"90+",9,5,4,
"164",2013,"0-4",156,84,72,
"164",2013,"5-9",149,80,69,
"164",2013,"10-14",106,47,59,
"164",2013,"15-19",128,72,56,
"164",2013,"20-24",132,63,69,
"164",2013,"25-29",129,69,60,
"164",2013,"30-34",133,70,63,
"164",2013,"35-39",105,51,54,
"164",2013,"40-44",56,35,21,
"164",2013,"45-49",107,58,49,
"164",2013,"50-54",144,88,56,
"164",2013,"55-59",127,73,54,
"164",2013,"60-64",84,41,43,
"164",2013,"65-69",57,35,22,
"164",2013,"70-74",42,20,22,
"164",2013,"75-79",19,11,8,
"164",2013,"80-84",17,12,5,
"164",2013,"85-89",6,1,5,
"164",2013,"90+",3,1,2,
"170",2013,"0-4",7186,3718,3468,
"170",2013,"5-9",7950,4060,3890,
"170",2013,"10-14",7528,3905,3623,
"170",2013,"15-19",7043,3765,3278,
"170",2013,"20-24",5398,2842,2556,
"170",2013,"25-29",6155,3040,3115,
"170",2013,"30-34",6501,3255,3246,
"170",2013,"35-39",6051,3142,2909,
"170",2013,"40-44",6509,3294,3215,
"170",2013,"45-49",6398,3325,3073,
"170",2013,"50-54",7507,3845,3662,
"170",2013,"55-59",7074,3719,3355,
"170",2013,"60-64",5692,2918,2774,
"170",2013,"65-69",3620,1871,1749,
"170",2013,"70-74",2383,1287,1096,
"170",2013,"75-79",1389,703,686,
"170",2013,"80-84",894,432,462,
"170",2013,"85-89",482,182,300,
"170",2013,"90+",188,62,126,
"180",2013,"0-4",1053,564,489,
"180",2013,"5-9",949,486,463,
"180",2013,"10-14",920,474,446,
"180",2013,"15-19",766,417,349,
"180",2013,"20-24",832,435,397,
"180",2013,"25-29",767,407,360,
"180",2013,"30-34",629,333,296,
"180",2013,"35-39",578,298,280,
"180",2013,"40-44",527,291,236,
"180",2013,"45-49",542,302,240,
"180",2013,"50-54",640,352,288,
"180",2013,"55-59",549,288,261,
"180",2013,"60-64",458,250,208,
"180",2013,"65-69",290,176,114,
"180",2013,"70-74",144,85,59,
"180",2013,"75-79",116,46,70,
"180",2013,"80-84",76,33,43,
"180",2013,"85-89",27,14,13,
"180",2013,"90+",11,4,7,
"185",2013,"0-4",775,373,402,
"185",2013,"5-9",745,397,348,
"185",2013,"10-14",621,319,302,
"185",2013,"15-19",537,296,241,
"185",2013,"20-24",795,457,338,
"185",2013,"25-29",858,523,335,
"185",2013,"30-34",789,519,270,
"185",2013,"35-39",635,436,199,
"185",2013,"40-44",521,337,184,
"185",2013,"45-49",806,579,227,
"185",2013,"50-54",886,571,315,
"185",2013,"55-59",927,678,249,
"185",2013,"60-64",542,381,161,
"185",2013,"65-69",217,146,71,
"185",2013,"70-74",93,54,39,
"185",2013,"75-79",62,24,38,
"185",2013,"80-84",45,21,24,
"185",2013,"85-89",17,8,9,
"185",2013,"90+",5,2,3,
"188",2013,"0-4",895,483,412,
"188",2013,"5-9",781,398,383,
"188",2013,"10-14",713,345,368,
"188",2013,"15-19",632,319,313,
"188",2013,"20-24",720,401,319,
"188",2013,"25-29",622,324,298,
"188",2013,"30-34",546,303,243,
"188",2013,"35-39",388,218,170,
"188",2013,"40-44",389,206,183,
"188",2013,"45-49",441,264,177,
"188",2013,"50-54",466,266,200,
"188",2013,"55-59",402,237,165,
"188",2013,"60-64",298,181,117,
"188",2013,"65-69",207,98,109,
"188",2013,"70-74",116,65,51,
"188",2013,"75-79",84,40,44,
"188",2013,"80-84",62,19,43,
"188",2013,"85-89",39,12,27,
"188",2013,"90+",8,1,7,
"195",2013,"0-4",240,116,124,
"195",2013,"5-9",165,81,84,
"195",2013,"10-14",221,112,109,
"195",2013,"15-19",174,100,74,
"195",2013,"20-24",141,64,77,
"195",2013,"25-29",200,91,109,
"195",2013,"30-34",192,103,89,
"195",2013,"35-39",176,88,88,
"195",2013,"40-44",204,103,101,
"195",2013,"45-49",218,116,102,
"195",2013,"50-54",241,121,120,
"195",2013,"55-59",297,146,151,
"195",2013,"60-64",272,153,119,
"195",2013,"65-69",208,128,80,
"195",2013,"70-74",106,60,46,
"195",2013,"75-79",61,35,26,
"195",2013,"80-84",43,15,28,
"195",2013,"85-89",30,16,14,
"195",2013,"90+",13,5,8,
"198",2013,"0-4",459,202,257,
"198",2013,"5-9",482,258,224,
"198",2013,"10-14",452,243,209,
"198",2013,"15-19",404,224,180,
"198",2013,"20-24",341,204,137,
"198",2013,"25-29",343,177,166,
"198",2013,"30-34",394,213,181,
"198",2013,"35-39",374,190,184,
"198",2013,"40-44",400,193,207,
"198",2013,"45-49",469,274,195,
"198",2013,"50-54",580,317,263,
"198",2013,"55-59",557,301,256,
"198",2013,"60-64",501,296,205,
"198",2013,"65-69",344,205,139,
"198",2013,"70-74",196,115,81,
"198",2013,"75-79",121,78,43,
"198",2013,"80-84",67,26,41,
"198",2013,"85-89",18,10,8,
"198",2013,"90+",13,9,4,
"220",2013,"0-4",585,281,304,
"220",2013,"5-9",604,335,269,
"220",2013,"10-14",563,297,266,
"220",2013,"15-19",515,258,257,
"220",2013,"20-24",484,242,242,
"220",2013,"25-29",620,256,364,
"220",2013,"30-34",654,337,317,
"220",2013,"35-39",614,330,284,
"220",2013,"40-44",579,281,298,
"220",2013,"45-49",549,287,262,
"220",2013,"50-54",701,366,335,
"220",2013,"55-59",774,370,404,
"220",2013,"60-64",632,332,300,
"220",2013,"65-69",403,206,197,
"220",2013,"70-74",262,133,129,
"220",2013,"75-79",240,100,140,
"220",2013,"80-84",125,52,73,
"220",2013,"85-89",102,29,73,
"220",2013,"90+",60,14,46,
"230",2013,"0-4",60,27,33,
"230",2013,"5-9",44,28,16,
"230",2013,"10-14",26,12,14,
"230",2013,"15-19",23,13,10,
"230",2013,"20-24",48,21,27,
"230",2013,"25-29",67,33,34,
"230",2013,"30-34",101,55,46,
"230",2013,"35-39",73,35,38,
"230",2013,"40-44",80,45,35,
"230",2013,"45-49",82,43,39,
"230",2013,"50-54",72,38,34,
"230",2013,"55-59",104,61,43,
"230",2013,"60-64",82,49,33,
"230",2013,"65-69",60,27,33,
"230",2013,"70-74",29,13,16,
"230",2013,"75-79",21,5,16,
"230",2013,"80-84",5,2,3,
"230",2013,"85-89",3,2,1,
"230",2013,"90+",3,1,2,
"240",2013,"0-4",469,225,244,
"240",2013,"5-9",542,293,249,
"240",2013,"10-14",540,297,243,
"240",2013,"15-19",452,248,204,
"240",2013,"20-24",392,200,192,
"240",2013,"25-29",399,220,179,
"240",2013,"30-34",539,297,242,
"240",2013,"35-39",421,238,183,
"240",2013,"40-44",441,249,192,
"240",2013,"45-49",499,287,212,
"240",2013,"50-54",534,308,226,
"240",2013,"55-59",598,319,279,
"240",2013,"60-64",466,289,177,
"240",2013,"65-69",315,193,122,
"240",2013,"70-74",240,134,106,
"240",2013,"75-79",120,66,54,
"240",2013,"80-84",63,35,28,
"240",2013,"85-89",44,12,32,
"240",2013,"90+",19,4,15,
"275",2013,"0-4",146,63,83,
"275",2013,"5-9",150,71,79,
"275",2013,"10-14",156,84,72,
"275",2013,"15-19",141,76,65,
"275",2013,"20-24",96,45,51,
"275",2013,"25-29",147,66,81,
"275",2013,"30-34",113,62,51,
"275",2013,"35-39",90,43,47,
"275",2013,"40-44",123,57,66,
"275",2013,"45-49",170,93,77,
"275",2013,"50-54",208,103,105,
"275",2013,"55-59",271,151,120,
"275",2013,"60-64",220,114,106,
"275",2013,"65-69",149,78,71,
"275",2013,"70-74",104,57,47,
"275",2013,"75-79",94,52,42,
"275",2013,"80-84",48,23,25,
"275",2013,"85-89",13,2,11,
"275",2013,"90+",18,11,7,
"282",2013,"0-4",36,16,20,
"282",2013,"5-9",30,17,13,
"282",2013,"10-14",38,15,23,
"282",2013,"15-19",39,23,16,
"282",2013,"20-24",38,22,16,
"282",2013,"25-29",26,16,10,
"282",2013,"30-34",36,19,17,
"282",2013,"35-39",37,20,17,
"282",2013,"40-44",41,23,18,
"282",2013,"45-49",56,32,24,
"282",2013,"50-54",47,32,15,
"282",2013,"55-59",48,27,21,
"282",2013,"60-64",60,37,23,
"282",2013,"65-69",38,17,21,
"282",2013,"70-74",19,16,3,
"282",2013,"75-79",11,4,7,
"282",2013,"80-84",13,1,12,
"282",2013,"85-89",5,1,4,
"282",2013,"90+",1,0,1,
"290",2013,"0-4",459,244,215,
"290",2013,"5-9",419,231,188,
"290",2013,"10-14",445,220,225,
"290",2013,"15-19",395,222,173,
"290",2013,"20-24",346,185,161,
"290",2013,"25-29",372,196,176,
"290",2013,"30-34",358,219,139,
"290",2013,"35-39",319,157,162,
"290",2013,"40-44",258,120,138,
"290",2013,"45-49",332,184,148,
"290",2013,"50-54",443,236,207,
"290",2013,"55-59",467,261,206,
"290",2013,"60-64",396,221,175,
"290",2013,"65-69",253,142,111,
"290",2013,"70-74",156,87,69,
"290",2013,"75-79",95,56,39,
"290",2013,"80-84",86,38,48,
"290",2013,"85-89",39,24,15,
"290",2013,"90+",11,4,7,
"000",2014,"0-4",53438,27251,26187,
"000",2014,"5-9",53989,28020,25969,
"000",2014,"10-14",51222,26307,24915,
"000",2014,"15-19",48490,25338,23152,
"000",2014,"20-24",54487,29567,24920,
"000",2014,"25-29",57726,30205,27521,
"000",2014,"30-34",55925,28954,26971,
"000",2014,"35-39",46612,24100,22512,
"000",2014,"40-44",45168,23349,21819,
"000",2014,"45-49",46326,23939,22387,
"000",2014,"50-54",54556,28372,26184,
"000",2014,"55-59",53628,27545,26083,
"000",2014,"60-64",44282,23307,20975,
"000",2014,"65-69",29660,15659,14001,
"000",2014,"70-74",18028,9205,8823,
"000",2014,"75-79",10760,5265,5495,
"000",2014,"80-84",6883,3077,3806,
"000",2014,"85-89",3817,1478,2339,
"000",2014,"90+",2056,687,1369,
"013",2014,"0-4",108,53,55,
"013",2014,"5-9",98,49,49,
"013",2014,"10-14",79,39,40,
"013",2014,"15-19",115,64,51,
"013",2014,"20-24",222,160,62,
"013",2014,"25-29",216,162,54,
"013",2014,"30-34",306,203,103,
"013",2014,"35-39",249,162,87,
"013",2014,"40-44",226,174,52,
"013",2014,"45-49",304,216,88,
"013",2014,"50-54",417,261,156,
"013",2014,"55-59",351,221,130,
"013",2014,"60-64",176,108,68,
"013",2014,"65-69",124,82,42,
"013",2014,"70-74",47,27,20,
"013",2014,"75-79",31,18,13,
"013",2014,"80-84",13,10,3,
"013",2014,"85-89",15,12,3,
"013",2014,"90+",0,0,0,
"016",2014,"0-4",189,100,89,
"016",2014,"5-9",245,119,126,
"016",2014,"10-14",206,122,84,
"016",2014,"15-19",241,141,100,
"016",2014,"20-24",315,215,100,
"016",2014,"25-29",471,332,139,
"016",2014,"30-34",496,350,146,
"016",2014,"35-39",526,364,162,
"016",2014,"40-44",439,319,120,
"016",2014,"45-49",562,378,184,
"016",2014,"50-54",673,460,213,
"016",2014,"55-59",484,339,145,
"016",2014,"60-64",397,263,134,
"016",2014,"65-69",248,164,84,
"016",2014,"70-74",58,36,22,
"016",2014,"75-79",20,9,11,
"016",2014,"80-84",14,10,4,
"016",2014,"85-89",13,3,10,
"016",2014,"90+",1,1,0,
"020",2014,"0-4",21642,11165,10477,
"020",2014,"5-9",21294,11004,10290,
"020",2014,"10-14",20308,10468,9840,
"020",2014,"15-19",19442,9904,9538,
"020",2014,"20-24",24683,13219,11464,
"020",2014,"25-29",25697,13290,12407,
"020",2014,"30-34",24235,12194,12041,
"020",2014,"35-39",19425,9724,9701,
"020",2014,"40-44",18862,9511,9351,
"020",2014,"45-49",18755,9273,9482,
"020",2014,"50-54",21713,10919,10794,
"020",2014,"55-59",20527,10167,10360,
"020",2014,"60-64",16439,8317,8122,
"020",2014,"65-69",11256,5695,5561,
"020",2014,"70-74",6559,3207,3352,
"020",2014,"75-79",4189,1879,2310,
"020",2014,"80-84",2762,1178,1584,
"020",2014,"85-89",1516,558,958,
"020",2014,"90+",948,300,648,
"050",2014,"0-4",1843,942,901,
"050",2014,"5-9",1849,920,929,
"050",2014,"10-14",1725,896,829,
"050",2014,"15-19",1606,855,751,
"050",2014,"20-24",1487,720,767,
"050",2014,"25-29",1482,773,709,
"050",2014,"30-34",1219,615,604,
"050",2014,"35-39",913,471,442,
"050",2014,"40-44",902,447,455,
"050",2014,"45-49",998,560,438,
"050",2014,"50-54",1126,643,483,
"050",2014,"55-59",997,515,482,
"050",2014,"60-64",779,429,350,
"050",2014,"65-69",451,245,206,
"050",2014,"70-74",314,154,160,
"050",2014,"75-79",189,104,85,
"050",2014,"80-84",135,45,90,
"050",2014,"85-89",60,33,27,
"050",2014,"90+",16,7,9,
"060",2014,"0-4",44,27,17,
"060",2014,"5-9",41,23,18,
"060",2014,"10-14",55,26,29,
"060",2014,"15-19",73,37,36,
"060",2014,"20-24",43,29,14,
"060",2014,"25-29",80,41,39,
"060",2014,"30-34",48,25,23,
"060",2014,"35-39",48,24,24,
"060",2014,"40-44",67,41,26,
"060",2014,"45-49",66,36,30,
"060",2014,"50-54",96,51,45,
"060",2014,"55-59",110,67,43,
"060",2014,"60-64",81,50,31,
"060",2014,"65-69",32,17,15,
"060",2014,"70-74",23,17,6,
"060",2014,"75-79",22,9,13,
"060",2014,"80-84",9,6,3,
"060",2014,"85-89",5,1,4,
"060",2014,"90+",1,0,1,
"063",2014,"0-4",463,214,249,
"063",2014,"5-9",439,220,219,
"063",2014,"10-14",440,220,220,
"063",2014,"15-19",398,209,189,
"063",2014,"20-24",370,206,164,
"063",2014,"25-29",576,328,248,
"063",2014,"30-34",484,258,226,
"063",2014,"35-39",416,227,189,
"063",2014,"40-44",433,221,212,
"063",2014,"45-49",479,251,228,
"063",2014,"50-54",593,337,256,
"063",2014,"55-59",627,325,302,
"063",2014,"60-64",461,255,206,
"063",2014,"65-69",286,147,139,
"063",2014,"70-74",164,77,87,
"063",2014,"75-79",79,47,32,
"063",2014,"80-84",42,17,25,
"063",2014,"85-89",26,11,15,
"063",2014,"90+",13,3,10,
"066",2014,"0-4",179,92,87,
"066",2014,"5-9",211,108,103,
"066",2014,"10-14",214,102,112,
"066",2014,"15-19",183,86,97,
"066",2014,"20-24",105,60,45,
"066",2014,"25-29",128,63,65,
"066",2014,"30-34",179,88,91,
"066",2014,"35-39",141,70,71,
"066",2014,"40-44",139,74,65,
"066",2014,"45-49",180,100,80,
"066",2014,"50-54",246,128,118,
"066",2014,"55-59",285,159,126,
"066",2014,"60-64",267,163,104,
"066",2014,"65-69",142,85,57,
"066",2014,"70-74",103,56,47,
"066",2014,"75-79",63,38,25,
"066",2014,"80-84",21,14,7,
"066",2014,"85-89",18,4,14,
"066",2014,"90+",8,4,4,
"068",2014,"0-4",101,60,41,
"068",2014,"5-9",99,59,40,
"068",2014,"10-14",117,56,61,
"068",2014,"15-19",93,44,49,
"068",2014,"20-24",45,26,19,
"068",2014,"25-29",87,38,49,
"068",2014,"30-34",136,68,68,
"068",2014,"35-39",123,56,67,
"068",2014,"40-44",132,72,60,
"068",2014,"45-49",156,91,65,
"068",2014,"50-54",168,105,63,
"068",2014,"55-59",153,82,71,
"068",2014,"60-64",201,137,64,
"068",2014,"65-69",55,34,21,
"068",2014,"70-74",61,36,25,
"068",2014,"75-79",27,14,13,
"068",2014,"80-84",21,15,6,
"068",2014,"85-89",3,3,0,
"068",2014,"90+",0,0,0,
"070",2014,"0-4",502,233,269,
"070",2014,"5-9",448,236,212,
"070",2014,"10-14",400,211,189,
"070",2014,"15-19",435,226,209,
"070",2014,"20-24",402,204,198,
"070",2014,"25-29",368,197,171,
"070",2014,"30-34",316,159,157,
"070",2014,"35-39",248,126,122,
"070",2014,"40-44",240,122,118,
"070",2014,"45-49",299,143,156,
"070",2014,"50-54",335,191,144,
"070",2014,"55-59",387,206,181,
"070",2014,"60-64",273,147,126,
"070",2014,"65-69",141,75,66,
"070",2014,"70-74",126,59,67,
"070",2014,"75-79",72,46,26,
"070",2014,"80-84",43,19,24,
"070",2014,"85-89",21,10,11,
"070",2014,"90+",10,8,2,
"090",2014,"0-4",7237,3671,3566,
"090",2014,"5-9",7088,3708,3380,
"090",2014,"10-14",6462,3384,3078,
"090",2014,"15-19",6190,3267,2923,
"090",2014,"20-24",9140,5240,3900,
"090",2014,"25-29",8775,4724,4051,
"090",2014,"30-34",8091,4312,3779,
"090",2014,"35-39",6403,3283,3120,
"090",2014,"40-44",6044,3207,2837,
"090",2014,"45-49",5628,2841,2787,
"090",2014,"50-54",6775,3427,3348,
"090",2014,"55-59",6749,3437,3312,
"090",2014,"60-64",5687,3017,2670,
"090",2014,"65-69",3715,2024,1691,
"090",2014,"70-74",2246,1130,1116,
"090",2014,"75-79",1143,592,551,
"090",2014,"80-84",769,339,430,
"090",2014,"85-89",466,177,289,
"090",2014,"90+",220,68,152,
"100",2014,"0-4",123,62,61,
"100",2014,"5-9",132,62,70,
"100",2014,"10-14",128,72,56,
"100",2014,"15-19",123,63,60,
"100",2014,"20-24",86,48,38,
"100",2014,"25-29",128,70,58,
"100",2014,"30-34",135,65,70,
"100",2014,"35-39",150,74,76,
"100",2014,"40-44",154,79,75,
"100",2014,"45-49",167,85,82,
"100",2014,"50-54",235,119,116,
"100",2014,"55-59",279,134,145,
"100",2014,"60-64",255,127,128,
"100",2014,"65-69",199,105,94,
"100",2014,"70-74",110,53,57,
"100",2014,"75-79",52,22,30,
"100",2014,"80-84",56,21,35,
"100",2014,"85-89",24,12,12,
"100",2014,"90+",16,6,10,
"105",2014,"0-4",125,69,56,
"105",2014,"5-9",129,67,62,
"105",2014,"10-14",105,39,66,
"105",2014,"15-19",96,45,51,
"105",2014,"20-24",83,51,32,
"105",2014,"25-29",109,56,53,
"105",2014,"30-34",118,68,50,
"105",2014,"35-39",123,52,71,
"105",2014,"40-44",109,66,43,
"105",2014,"45-49",127,69,58,
"105",2014,"50-54",197,98,99,
"105",2014,"55-59",214,114,100,
"105",2014,"60-64",233,122,111,
"105",2014,"65-69",164,106,58,
"105",2014,"70-74",88,52,36,
"105",2014,"75-79",78,50,28,
"105",2014,"80-84",28,21,7,
"105",2014,"85-89",8,2,6,
"105",2014,"90+",5,3,2,
"110",2014,"0-4",1991,1020,971,
"110",2014,"5-9",2131,1057,1074,
"110",2014,"10-14",2052,1038,1014,
"110",2014,"15-19",1999,1072,927,
"110",2014,"20-24",2044,1028,1016,
"110",2014,"25-29",2569,1298,1271,
"110",2014,"30-34",2617,1355,1262,
"110",2014,"35-39",2100,1073,1027,
"110",2014,"40-44",2104,1040,1064,
"110",2014,"45-49",2368,1239,1129,
"110",2014,"50-54",2722,1403,1319,
"110",2014,"55-59",2619,1330,1289,
"110",2014,"60-64",2247,1164,1083,
"110",2014,"65-69",1516,775,741,
"110",2014,"70-74",851,430,421,
"110",2014,"75-79",524,222,302,
"110",2014,"80-84",287,124,163,
"110",2014,"85-89",192,73,119,
"110",2014,"90+",94,30,64,
"122",2014,"0-4",3586,1763,1823,
"122",2014,"5-9",3692,1914,1778,
"122",2014,"10-14",3694,1815,1879,
"122",2014,"15-19",3628,1888,1740,
"122",2014,"20-24",3084,1782,1302,
"122",2014,"25-29",3328,1760,1568,
"122",2014,"30-34",3567,1849,1718,
"122",2014,"35-39",3384,1798,1586,
"122",2014,"40-44",3399,1794,1605,
"122",2014,"45-49",3563,1839,1724,
"122",2014,"50-54",4518,2355,2163,
"122",2014,"55-59",5118,2523,2595,
"122",2014,"60-64",4717,2515,2202,
"122",2014,"65-69",3287,1816,1471,
"122",2014,"70-74",2224,1187,1037,
"122",2014,"75-79",1242,639,603,
"122",2014,"80-84",739,362,377,
"122",2014,"85-89",424,180,244,
"122",2014,"90+",248,87,161,
"130",2014,"0-4",886,437,449,
"130",2014,"5-9",856,454,402,
"130",2014,"10-14",881,456,425,
"130",2014,"15-19",896,455,441,
"130",2014,"20-24",852,475,377,
"130",2014,"25-29",928,492,436,
"130",2014,"30-34",945,489,456,
"130",2014,"35-39",818,384,434,
"130",2014,"40-44",816,406,410,
"130",2014,"45-49",912,445,467,
"130",2014,"50-54",1145,610,535,
"130",2014,"55-59",1178,588,590,
"130",2014,"60-64",1001,520,481,
"130",2014,"65-69",695,343,352,
"130",2014,"70-74",475,232,243,
"130",2014,"75-79",269,150,119,
"130",2014,"80-84",172,73,99,
"130",2014,"85-89",103,50,53,
"130",2014,"90+",75,25,50,
"150",2014,"0-4",1092,565,527,
"150",2014,"5-9",1019,512,507,
"150",2014,"10-14",967,510,457,
"150",2014,"15-19",999,540,459,
"150",2014,"20-24",986,539,447,
"150",2014,"25-29",1138,630,508,
"150",2014,"30-34",1044,541,503,
"150",2014,"35-39",872,462,410,
"150",2014,"40-44",788,397,391,
"150",2014,"45-49",887,454,433,
"150",2014,"50-54",1025,537,488,
"150",2014,"55-59",1044,575,469,
"150",2014,"60-64",734,402,332,
"150",2014,"65-69",551,260,291,
"150",2014,"70-74",326,169,157,
"150",2014,"75-79",172,90,82,
"150",2014,"80-84",97,43,54,
"150",2014,"85-89",50,15,35,
"150",2014,"90+",21,7,14,
"158",2014,"0-4",927,485,442,
"158",2014,"5-9",927,508,419,
"158",2014,"10-14",892,446,446,
"158",2014,"15-19",797,417,380,
"158",2014,"20-24",802,425,377,
"158",2014,"25-29",680,351,329,
"158",2014,"30-34",474,247,227,
"158",2014,"35-39",390,214,176,
"158",2014,"40-44",343,166,177,
"158",2014,"45-49",405,213,192,
"158",2014,"50-54",398,205,193,
"158",2014,"55-59",352,204,148,
"158",2014,"60-64",258,132,126,
"158",2014,"65-69",187,106,81,
"158",2014,"70-74",99,43,56,
"158",2014,"75-79",76,36,40,
"158",2014,"80-84",55,21,34,
"158",2014,"85-89",16,6,10,
"158",2014,"90+",9,5,4,
"164",2014,"0-4",139,75,64,
"164",2014,"5-9",141,80,61,
"164",2014,"10-14",109,50,59,
"164",2014,"15-19",123,64,59,
"164",2014,"20-24",123,54,69,
"164",2014,"25-29",143,76,67,
"164",2014,"30-34",130,62,68,
"164",2014,"35-39",120,71,49,
"164",2014,"40-44",64,37,27,
"164",2014,"45-49",89,47,42,
"164",2014,"50-54",140,81,59,
"164",2014,"55-59",125,73,52,
"164",2014,"60-64",92,43,49,
"164",2014,"65-69",52,33,19,
"164",2014,"70-74",49,22,27,
"164",2014,"75-79",22,12,10,
"164",2014,"80-84",19,14,5,
"164",2014,"85-89",5,1,4,
"164",2014,"90+",4,2,2,
"170",2014,"0-4",7323,3727,3596,
"170",2014,"5-9",8113,4251,3862,
"170",2014,"10-14",7802,4033,3769,
"170",2014,"15-19",7051,3782,3269,
"170",2014,"20-24",5528,2905,2623,
"170",2014,"25-29",6278,3156,3122,
"170",2014,"30-34",6916,3489,3427,
"170",2014,"35-39",6306,3280,3026,
"170",2014,"40-44",6409,3265,3144,
"170",2014,"45-49",6381,3347,3034,
"170",2014,"50-54",7324,3733,3591,
"170",2014,"55-59",7143,3750,3393,
"170",2014,"60-64",6057,3100,2957,
"170",2014,"65-69",3942,2059,1883,
"170",2014,"70-74",2609,1377,1232,
"170",2014,"75-79",1436,755,681,
"170",2014,"80-84",951,474,477,
"170",2014,"85-89",507,203,304,
"170",2014,"90+",192,64,128,
"180",2014,"0-4",1007,532,475,
"180",2014,"5-9",1022,531,491,
"180",2014,"10-14",910,467,443,
"180",2014,"15-19",760,405,355,
"180",2014,"20-24",799,421,378,
"180",2014,"25-29",857,447,410,
"180",2014,"30-34",651,338,313,
"180",2014,"35-39",585,299,286,
"180",2014,"40-44",523,290,233,
"180",2014,"45-49",524,292,232,
"180",2014,"50-54",607,340,267,
"180",2014,"55-59",548,290,258,
"180",2014,"60-64",492,261,231,
"180",2014,"65-69",305,190,115,
"180",2014,"70-74",157,85,72,
"180",2014,"75-79",112,46,66,
"180",2014,"80-84",78,37,41,
"180",2014,"85-89",27,10,17,
"180",2014,"90+",8,4,4,
"185",2014,"0-4",746,371,375,
"185",2014,"5-9",719,383,336,
"185",2014,"10-14",644,332,312,
"185",2014,"15-19",500,262,238,
"185",2014,"20-24",727,426,301,
"185",2014,"25-29",834,502,332,
"185",2014,"30-34",874,579,295,
"185",2014,"35-39",699,495,204,
"185",2014,"40-44",532,350,182,
"185",2014,"45-49",710,503,207,
"185",2014,"50-54",855,571,284,
"185",2014,"55-59",893,636,257,
"185",2014,"60-64",551,380,171,
"185",2014,"65-69",236,159,77,
"185",2014,"70-74",97,59,38,
"185",2014,"75-79",55,23,32,
"185",2014,"80-84",42,14,28,
"185",2014,"85-89",18,8,10,
"185",2014,"90+",5,4,1,
"188",2014,"0-4",828,432,396,
"188",2014,"5-9",804,423,381,
"188",2014,"10-14",687,337,350,
"188",2014,"15-19",645,339,306,
"188",2014,"20-24",673,356,317,
"188",2014,"25-29",662,358,304,
"188",2014,"30-34",553,303,250,
"188",2014,"35-39",409,231,178,
"188",2014,"40-44",383,195,188,
"188",2014,"45-49",416,256,160,
"188",2014,"50-54",504,291,213,
"188",2014,"55-59",412,239,173,
"188",2014,"60-64",281,167,114,
"188",2014,"65-69",220,109,111,
"188",2014,"70-74",116,62,54,
"188",2014,"75-79",85,42,43,
"188",2014,"80-84",67,23,44,
"188",2014,"85-89",46,9,37,
"188",2014,"90+",8,2,6,
"195",2014,"0-4",233,121,112,
"195",2014,"5-9",172,85,87,
"195",2014,"10-14",220,110,110,
"195",2014,"15-19",173,103,70,
"195",2014,"20-24",136,68,68,
"195",2014,"25-29",190,92,98,
"195",2014,"30-34",196,95,101,
"195",2014,"35-39",196,100,96,
"195",2014,"40-44",183,92,91,
"195",2014,"45-49",232,118,114,
"195",2014,"50-54",228,126,102,
"195",2014,"55-59",300,137,163,
"195",2014,"60-64",260,149,111,
"195",2014,"65-69",214,126,88,
"195",2014,"70-74",119,69,50,
"195",2014,"75-79",64,36,28,
"195",2014,"80-84",43,15,28,
"195",2014,"85-89",28,14,14,
"195",2014,"90+",15,7,8,
"198",2014,"0-4",442,216,226,
"198",2014,"5-9",503,264,239,
"198",2014,"10-14",441,237,204,
"198",2014,"15-19",398,228,170,
"198",2014,"20-24",332,194,138,
"198",2014,"25-29",358,179,179,
"198",2014,"30-34",391,218,173,
"198",2014,"35-39",382,205,177,
"198",2014,"40-44",399,202,197,
"198",2014,"45-49",443,245,198,
"198",2014,"50-54",597,338,259,
"198",2014,"55-59",540,287,253,
"198",2014,"60-64",493,281,212,
"198",2014,"65-69",359,216,143,
"198",2014,"70-74",210,121,89,
"198",2014,"75-79",133,84,49,
"198",2014,"80-84",65,29,36,
"198",2014,"85-89",20,10,10,
"198",2014,"90+",14,9,5,
"220",2014,"0-4",570,265,305,
"220",2014,"5-9",625,364,261,
"220",2014,"10-14",548,267,281,
"220",2014,"15-19",514,277,237,
"220",2014,"20-24",519,244,275,
"220",2014,"25-29",633,282,351,
"220",2014,"30-34",644,320,324,
"220",2014,"35-39",648,347,301,
"220",2014,"40-44",551,287,264,
"220",2014,"45-49",555,276,279,
"220",2014,"50-54",660,339,321,
"220",2014,"55-59",777,383,394,
"220",2014,"60-64",609,319,290,
"220",2014,"65-69",428,219,209,
"220",2014,"70-74",250,128,122,
"220",2014,"75-79",253,105,148,
"220",2014,"80-84",133,57,76,
"220",2014,"85-89",90,26,64,
"220",2014,"90+",71,17,54,
"230",2014,"0-4",58,30,28,
"230",2014,"5-9",49,27,22,
"230",2014,"10-14",30,14,16,
"230",2014,"15-19",26,14,12,
"230",2014,"20-24",55,26,29,
"230",2014,"25-29",67,25,42,
"230",2014,"30-34",108,56,52,
"230",2014,"35-39",83,43,40,
"230",2014,"40-44",89,43,46,
"230",2014,"45-49",99,55,44,
"230",2014,"50-54",69,42,27,
"230",2014,"55-59",87,52,35,
"230",2014,"60-64",88,53,35,
"230",2014,"65-69",67,28,39,
"230",2014,"70-74",31,15,16,
"230",2014,"75-79",19,5,14,
"230",2014,"80-84",9,3,6,
"230",2014,"85-89",2,1,1,
"230",2014,"90+",3,1,2,
"240",2014,"0-4",455,220,235,
"240",2014,"5-9",522,272,250,
"240",2014,"10-14",517,277,240,
"240",2014,"15-19",422,227,195,
"240",2014,"20-24",378,193,185,
"240",2014,"25-29",397,220,177,
"240",2014,"30-34",538,305,233,
"240",2014,"35-39",428,246,182,
"240",2014,"40-44",424,242,182,
"240",2014,"45-49",501,289,212,
"240",2014,"50-54",532,320,212,
"240",2014,"55-59",566,296,270,
"240",2014,"60-64",474,297,177,
"240",2014,"65-69",331,204,127,
"240",2014,"70-74",229,136,93,
"240",2014,"75-79",139,71,68,
"240",2014,"80-84",60,33,27,
"240",2014,"85-89",48,14,34,
"240",2014,"90+",17,4,13,
"275",2014,"0-4",155,73,82,
"275",2014,"5-9",144,66,78,
"275",2014,"10-14",137,70,67,
"275",2014,"15-19",132,74,58,
"275",2014,"20-24",107,54,53,
"275",2014,"25-29",151,63,88,
"275",2014,"30-34",121,69,52,
"275",2014,"35-39",78,38,40,
"275",2014,"40-44",124,60,64,
"275",2014,"45-49",145,73,72,
"275",2014,"50-54",199,96,103,
"275",2014,"55-59",268,141,127,
"275",2014,"60-64",220,118,102,
"275",2014,"65-69",163,91,72,
"275",2014,"70-74",106,55,51,
"275",2014,"75-79",88,57,31,
"275",2014,"80-84",47,23,24,
"275",2014,"85-89",15,3,12,
"275",2014,"90+",16,9,7,
"282",2014,"0-4",36,17,19,
"282",2014,"5-9",31,14,17,
"282",2014,"10-14",37,15,22,
"282",2014,"15-19",34,20,14,
"282",2014,"20-24",36,22,14,
"282",2014,"25-29",26,12,14,
"282",2014,"30-34",37,22,15,
"282",2014,"35-39",44,28,16,
"282",2014,"40-44",36,21,15,
"282",2014,"45-49",65,39,26,
"282",2014,"50-54",50,36,14,
"282",2014,"55-59",40,20,20,
"282",2014,"60-64",59,37,22,
"282",2014,"65-69",43,20,23,
"282",2014,"70-74",19,16,3,
"282",2014,"75-79",11,4,7,
"282",2014,"80-84",13,1,12,
"282",2014,"85-89",5,1,4,
"282",2014,"90+",2,0,2,
"290",2014,"0-4",408,214,194,
"290",2014,"5-9",446,240,206,
"290",2014,"10-14",415,198,217,
"290",2014,"15-19",398,230,168,
"290",2014,"20-24",325,177,148,
"290",2014,"25-29",370,188,182,
"290",2014,"30-34",356,212,144,
"290",2014,"35-39",305,153,152,
"290",2014,"40-44",254,129,125,
"290",2014,"45-49",310,166,144,
"290",2014,"50-54",409,210,199,
"290",2014,"55-59",455,255,200,
"290",2014,"60-64",400,234,166,
"290",2014,"65-69",251,126,125,
"290",2014,"70-74",162,95,67,
"290",2014,"75-79",95,60,35,
"290",2014,"80-84",93,36,57,
"290",2014,"85-89",46,28,18,
"290",2014,"90+",16,10,6,
"000",2015,"0-4",53084,27096,25988,
"000",2015,"5-9",54177,28057,26120,
"000",2015,"10-14",50906,26111,24795,
"000",2015,"15-19",48091,25217,22874,
"000",2015,"20-24",52934,28843,24091,
"000",2015,"25-29",58242,30546,27696,
"000",2015,"30-34",56987,29574,27413,
"000",2015,"35-39",47858,24756,23102,
"000",2015,"40-44",43994,22751,21243,
"000",2015,"45-49",45314,23359,21955,
"000",2015,"50-54",52608,27399,25209,
"000",2015,"55-59",53137,27407,25730,
"000",2015,"60-64",45595,23808,21787,
"000",2015,"65-69",31495,16620,14875,
"000",2015,"70-74",19103,9753,9350,
"000",2015,"75-79",11165,5492,5673,
"000",2015,"80-84",7012,3148,3864,
"000",2015,"85-89",3947,1559,2388,
"000",2015,"90+",2137,706,1431,
"013",2015,"0-4",89,43,46,
"013",2015,"5-9",95,46,49,
"013",2015,"10-14",72,41,31,
"013",2015,"15-19",104,58,46,
"013",2015,"20-24",222,172,50,
"013",2015,"25-29",197,144,53,
"013",2015,"30-34",282,189,93,
"013",2015,"35-39",263,179,84,
"013",2015,"40-44",254,171,83,
"013",2015,"45-49",325,238,87,
"013",2015,"50-54",408,258,150,
"013",2015,"55-59",341,223,118,
"013",2015,"60-64",174,109,65,
"013",2015,"65-69",108,69,39,
"013",2015,"70-74",61,35,26,
"013",2015,"75-79",28,17,11,
"013",2015,"80-84",14,8,6,
"013",2015,"85-89",13,10,3,
"013",2015,"90+",2,2,0,
"016",2015,"0-4",206,105,101,
"016",2015,"5-9",224,116,108,
"016",2015,"10-14",201,116,85,
"016",2015,"15-19",231,137,94,
"016",2015,"20-24",288,196,92,
"016",2015,"25-29",487,346,141,
"016",2015,"30-34",480,317,163,
"016",2015,"35-39",522,366,156,
"016",2015,"40-44",426,311,115,
"016",2015,"45-49",528,348,180,
"016",2015,"50-54",625,443,182,
"016",2015,"55-59",495,331,164,
"016",2015,"60-64",415,284,131,
"016",2015,"65-69",283,190,93,
"016",2015,"70-74",65,44,21,
"016",2015,"75-79",16,6,10,
"016",2015,"80-84",15,9,6,
"016",2015,"85-89",9,1,8,
"016",2015,"90+",2,2,0,
"020",2015,"0-4",21313,10992,10321,
"020",2015,"5-9",21124,10894,10230,
"020",2015,"10-14",19999,10303,9696,
"020",2015,"15-19",19082,9708,9374,
"020",2015,"20-24",23955,12888,11067,
"020",2015,"25-29",25735,13268,12467,
"020",2015,"30-34",24694,12538,12156,
"020",2015,"35-39",19937,9931,10006,
"020",2015,"40-44",18206,9123,9083,
"020",2015,"45-49",18270,9074,9196,
"020",2015,"50-54",20861,10409,10452,
"020",2015,"55-59",20264,10061,10203,
"020",2015,"60-64",17046,8646,8400,
"020",2015,"65-69",11824,5969,5855,
"020",2015,"70-74",6971,3414,3557,
"020",2015,"75-79",4307,1901,2406,
"020",2015,"80-84",2827,1219,1608,
"020",2015,"85-89",1550,581,969,
"020",2015,"90+",968,309,659,
"050",2015,"0-4",1870,966,904,
"050",2015,"5-9",1864,933,931,
"050",2015,"10-14",1726,891,835,
"050",2015,"15-19",1618,863,755,
"050",2015,"20-24",1433,699,734,
"050",2015,"25-29",1533,786,747,
"050",2015,"30-34",1226,627,599,
"050",2015,"35-39",967,492,475,
"050",2015,"40-44",879,432,447,
"050",2015,"45-49",961,542,419,
"050",2015,"50-54",1096,614,482,
"050",2015,"55-59",985,520,465,
"050",2015,"60-64",806,442,364,
"050",2015,"65-69",494,266,228,
"050",2015,"70-74",337,169,168,
"050",2015,"75-79",176,97,79,
"050",2015,"80-84",141,48,93,
"050",2015,"85-89",65,32,33,
"050",2015,"90+",12,6,6,
"060",2015,"0-4",46,24,22,
"060",2015,"5-9",34,17,17,
"060",2015,"10-14",48,23,25,
"060",2015,"15-19",67,36,31,
"060",2015,"20-24",36,23,13,
"060",2015,"25-29",62,29,33,
"060",2015,"30-34",55,27,28,
"060",2015,"35-39",41,21,20,
"060",2015,"40-44",66,39,27,
"060",2015,"45-49",56,29,27,
"060",2015,"50-54",88,49,39,
"060",2015,"55-59",105,62,43,
"060",2015,"60-64",87,54,33,
"060",2015,"65-69",35,16,19,
"060",2015,"70-74",24,18,6,
"060",2015,"75-79",24,8,16,
"060",2015,"80-84",6,3,3,
"060",2015,"85-89",4,2,2,
"060",2015,"90+",4,0,4,
"063",2015,"0-4",476,237,239,
"063",2015,"5-9",451,220,231,
"063",2015,"10-14",429,216,213,
"063",2015,"15-19",402,218,184,
"063",2015,"20-24",362,207,155,
"063",2015,"25-29",581,330,251,
"063",2015,"30-34",465,245,220,
"063",2015,"35-39",423,225,198,
"063",2015,"40-44",419,221,198,
"063",2015,"45-49",481,243,238,
"063",2015,"50-54",581,336,245,
"063",2015,"55-59",622,325,297,
"063",2015,"60-64",502,282,220,
"063",2015,"65-69",291,146,145,
"063",2015,"70-74",156,78,78,
"063",2015,"75-79",89,45,44,
"063",2015,"80-84",44,21,23,
"063",2015,"85-89",34,13,21,
"063",2015,"90+",10,2,8,
"066",2015,"0-4",173,88,85,
"066",2015,"5-9",203,105,98,
"066",2015,"10-14",197,88,109,
"066",2015,"15-19",171,86,85,
"066",2015,"20-24",104,57,47,
"066",2015,"25-29",120,59,61,
"066",2015,"30-34",179,93,86,
"066",2015,"35-39",134,68,66,
"066",2015,"40-44",110,58,52,
"066",2015,"45-49",181,94,87,
"066",2015,"50-54",224,121,103,
"066",2015,"55-59",292,158,134,
"066",2015,"60-64",268,164,104,
"066",2015,"65-69",145,86,59,
"066",2015,"70-74",98,58,40,
"066",2015,"75-79",74,42,32,
"066",2015,"80-84",17,9,8,
"066",2015,"85-89",20,7,13,
"066",2015,"90+",8,2,6,
"068",2015,"0-4",95,60,35,
"068",2015,"5-9",103,60,43,
"068",2015,"10-14",108,54,54,
"068",2015,"15-19",93,42,51,
"068",2015,"20-24",48,24,24,
"068",2015,"25-29",100,39,61,
"068",2015,"30-34",147,79,68,
"068",2015,"35-39",132,62,70,
"068",2015,"40-44",116,60,56,
"068",2015,"45-49",145,83,62,
"068",2015,"50-54",165,98,67,
"068",2015,"55-59",152,92,60,
"068",2015,"60-64",183,123,60,
"068",2015,"65-69",70,42,28,
"068",2015,"70-74",57,28,29,
"068",2015,"75-79",31,18,13,
"068",2015,"80-84",29,21,8,
"068",2015,"85-89",2,2,0,
"068",2015,"90+",1,1,0,
"070",2015,"0-4",467,211,256,
"070",2015,"5-9",455,247,208,
"070",2015,"10-14",391,197,194,
"070",2015,"15-19",418,215,203,
"070",2015,"20-24",389,209,180,
"070",2015,"25-29",430,230,200,
"070",2015,"30-34",284,135,149,
"070",2015,"35-39",267,134,133,
"070",2015,"40-44",208,109,99,
"070",2015,"45-49",284,139,145,
"070",2015,"50-54",349,190,159,
"070",2015,"55-59",358,188,170,
"070",2015,"60-64",286,163,123,
"070",2015,"65-69",145,72,73,
"070",2015,"70-74",126,63,63,
"070",2015,"75-79",75,49,26,
"070",2015,"80-84",48,21,27,
"070",2015,"85-89",22,11,11,
"070",2015,"90+",11,6,5,
"090",2015,"0-4",7311,3682,3629,
"090",2015,"5-9",7057,3719,3338,
"090",2015,"10-14",6485,3351,3134,
"090",2015,"15-19",6107,3271,2836,
"090",2015,"20-24",8991,5209,3782,
"090",2015,"25-29",8591,4609,3982,
"090",2015,"30-34",8165,4319,3846,
"090",2015,"35-39",6440,3331,3109,
"090",2015,"40-44",5918,3116,2802,
"090",2015,"45-49",5537,2805,2732,
"090",2015,"50-54",6579,3335,3244,
"090",2015,"55-59",6655,3405,3250,
"090",2015,"60-64",5860,3039,2821,
"090",2015,"65-69",3984,2161,1823,
"090",2015,"70-74",2427,1238,1189,
"090",2015,"75-79",1207,632,575,
"090",2015,"80-84",785,358,427,
"090",2015,"85-89",489,201,288,
"090",2015,"90+",220,68,152,
"100",2015,"0-4",105,49,56,
"100",2015,"5-9",144,74,70,
"100",2015,"10-14",113,62,51,
"100",2015,"15-19",122,64,58,
"100",2015,"20-24",76,42,34,
"100",2015,"25-29",117,63,54,
"100",2015,"30-34",150,75,75,
"100",2015,"35-39",138,66,72,
"100",2015,"40-44",126,66,60,
"100",2015,"45-49",182,94,88,
"100",2015,"50-54",214,108,106,
"100",2015,"55-59",268,133,135,
"100",2015,"60-64",258,131,127,
"100",2015,"65-69",208,104,104,
"100",2015,"70-74",118,60,58,
"100",2015,"75-79",62,25,37,
"100",2015,"80-84",48,21,27,
"100",2015,"85-89",27,10,17,
"100",2015,"90+",19,9,10,
"105",2015,"0-4",125,63,62,
"105",2015,"5-9",131,76,55,
"105",2015,"10-14",125,54,71,
"105",2015,"15-19",107,47,60,
"105",2015,"20-24",80,46,34,
"105",2015,"25-29",112,61,51,
"105",2015,"30-34",121,70,51,
"105",2015,"35-39",115,48,67,
"105",2015,"40-44",112,64,48,
"105",2015,"45-49",132,80,52,
"105",2015,"50-54",181,84,97,
"105",2015,"55-59",226,116,110,
"105",2015,"60-64",230,122,108,
"105",2015,"65-69",179,109,70,
"105",2015,"70-74",89,53,36,
"105",2015,"75-79",73,48,25,
"105",2015,"80-84",26,19,7,
"105",2015,"85-89",11,3,8,
"105",2015,"90+",4,2,2,
"110",2015,"0-4",2037,1070,967,
"110",2015,"5-9",2101,1031,1070,
"110",2015,"10-14",2047,1026,1021,
"110",2015,"15-19",2006,1064,942,
"110",2015,"20-24",1951,996,955,
"110",2015,"25-29",2609,1324,1285,
"110",2015,"30-34",2678,1378,1300,
"110",2015,"35-39",2221,1143,1078,
"110",2015,"40-44",2083,1066,1017,
"110",2015,"45-49",2262,1146,1116,
"110",2015,"50-54",2652,1367,1285,
"110",2015,"55-59",2590,1322,1268,
"110",2015,"60-64",2282,1171,1111,
"110",2015,"65-69",1609,819,790,
"110",2015,"70-74",893,449,444,
"110",2015,"75-79",541,241,300,
"110",2015,"80-84",305,131,174,
"110",2015,"85-89",199,80,119,
"110",2015,"90+",96,31,65,
"122",2015,"0-4",3549,1821,1728,
"122",2015,"5-9",3746,1909,1837,
"122",2015,"10-14",3707,1854,1853,
"122",2015,"15-19",3545,1873,1672,
"122",2015,"20-24",2971,1686,1285,
"122",2015,"25-29",3487,1866,1621,
"122",2015,"30-34",3690,1968,1722,
"122",2015,"35-39",3450,1855,1595,
"122",2015,"40-44",3365,1767,1598,
"122",2015,"45-49",3565,1858,1707,
"122",2015,"50-54",4280,2224,2056,
"122",2015,"55-59",5021,2520,2501,
"122",2015,"60-64",4763,2483,2280,
"122",2015,"65-69",3490,1905,1585,
"122",2015,"70-74",2319,1262,1057,
"122",2015,"75-79",1319,684,635,
"122",2015,"80-84",769,375,394,
"122",2015,"85-89",430,182,248,
"122",2015,"90+",262,82,180,
"130",2015,"0-4",894,436,458,
"130",2015,"5-9",835,438,397,
"130",2015,"10-14",857,442,415,
"130",2015,"15-19",930,484,446,
"130",2015,"20-24",811,439,372,
"130",2015,"25-29",971,513,458,
"130",2015,"30-34",890,457,433,
"130",2015,"35-39",838,417,421,
"130",2015,"40-44",800,393,407,
"130",2015,"45-49",899,431,468,
"130",2015,"50-54",1077,585,492,
"130",2015,"55-59",1132,568,564,
"130",2015,"60-64",1036,519,517,
"130",2015,"65-69",735,370,365,
"130",2015,"70-74",505,257,248,
"130",2015,"75-79",277,158,119,
"130",2015,"80-84",171,72,99,
"130",2015,"85-89",107,52,55,
"130",2015,"90+",76,23,53,
"150",2015,"0-4",1031,528,503,
"150",2015,"5-9",1034,518,516,
"150",2015,"10-14",951,485,466,
"150",2015,"15-19",997,554,443,
"150",2015,"20-24",913,493,420,
"150",2015,"25-29",1163,670,493,
"150",2015,"30-34",1042,553,489,
"150",2015,"35-39",889,459,430,
"150",2015,"40-44",768,381,387,
"150",2015,"45-49",867,433,434,
"150",2015,"50-54",988,524,464,
"150",2015,"55-59",1049,610,439,
"150",2015,"60-64",780,411,369,
"150",2015,"65-69",580,275,305,
"150",2015,"70-74",348,186,162,
"150",2015,"75-79",183,97,86,
"150",2015,"80-84",102,42,60,
"150",2015,"85-89",52,20,32,
"150",2015,"90+",24,6,18,
"158",2015,"0-4",898,461,437,
"158",2015,"5-9",953,525,428,
"158",2015,"10-14",898,439,459,
"158",2015,"15-19",821,424,397,
"158",2015,"20-24",762,405,357,
"158",2015,"25-29",757,401,356,
"158",2015,"30-34",467,240,227,
"158",2015,"35-39",379,206,173,
"158",2015,"40-44",354,185,169,
"158",2015,"45-49",413,206,207,
"158",2015,"50-54",408,211,197,
"158",2015,"55-59",368,216,152,
"158",2015,"60-64",257,127,130,
"158",2015,"65-69",200,114,86,
"158",2015,"70-74",112,48,64,
"158",2015,"75-79",71,34,37,
"158",2015,"80-84",57,23,34,
"158",2015,"85-89",18,5,13,
"158",2015,"90+",11,4,7,
"164",2015,"0-4",142,75,67,
"164",2015,"5-9",151,89,62,
"164",2015,"10-14",114,55,59,
"164",2015,"15-19",118,55,63,
"164",2015,"20-24",120,60,60,
"164",2015,"25-29",130,73,57,
"164",2015,"30-34",138,63,75,
"164",2015,"35-39",118,68,50,
"164",2015,"40-44",68,36,32,
"164",2015,"45-49",71,42,29,
"164",2015,"50-54",136,80,56,
"164",2015,"55-59",130,80,50,
"164",2015,"60-64",87,39,48,
"164",2015,"65-69",56,33,23,
"164",2015,"70-74",44,25,19,
"164",2015,"75-79",21,9,12,
"164",2015,"80-84",21,16,5,
"164",2015,"85-89",9,1,8,
"164",2015,"90+",3,1,2,
"170",2015,"0-4",7466,3776,3690,
"170",2015,"5-9",8325,4349,3976,
"170",2015,"10-14",7890,4072,3818,
"170",2015,"15-19",7076,3835,3241,
"170",2015,"20-24",5569,2917,2652,
"170",2015,"25-29",6382,3244,3138,
"170",2015,"30-34",7266,3690,3576,
"170",2015,"35-39",6605,3425,3180,
"170",2015,"40-44",6270,3242,3028,
"170",2015,"45-49",6370,3313,3057,
"170",2015,"50-54",7164,3744,3420,
"170",2015,"55-59",7231,3763,3468,
"170",2015,"60-64",6248,3162,3086,
"170",2015,"65-69",4312,2260,2052,
"170",2015,"70-74",2745,1404,1341,
"170",2015,"75-79",1535,828,707,
"170",2015,"80-84",946,458,488,
"170",2015,"85-89",527,225,302,
"170",2015,"90+",217,75,142,
"180",2015,"0-4",994,516,478,
"180",2015,"5-9",1024,536,488,
"180",2015,"10-14",940,484,456,
"180",2015,"15-19",775,423,352,
"180",2015,"20-24",754,393,361,
"180",2015,"25-29",865,467,398,
"180",2015,"30-34",713,373,340,
"180",2015,"35-39",620,334,286,
"180",2015,"40-44",536,300,236,
"180",2015,"45-49",488,264,224,
"180",2015,"50-54",586,342,244,
"180",2015,"55-59",558,290,268,
"180",2015,"60-64",477,255,222,
"180",2015,"65-69",307,192,115,
"180",2015,"70-74",178,92,86,
"180",2015,"75-79",100,51,49,
"180",2015,"80-84",75,39,36,
"180",2015,"85-89",31,8,23,
"180",2015,"90+",9,5,4,
"185",2015,"0-4",740,354,386,
"185",2015,"5-9",745,391,354,
"185",2015,"10-14",640,331,309,
"185",2015,"15-19",545,292,253,
"185",2015,"20-24",696,415,281,
"185",2015,"25-29",904,567,337,
"185",2015,"30-34",932,603,329,
"185",2015,"35-39",718,506,212,
"185",2015,"40-44",526,339,187,
"185",2015,"45-49",626,435,191,
"185",2015,"50-54",845,570,275,
"185",2015,"55-59",924,648,276,
"185",2015,"60-64",585,392,193,
"185",2015,"65-69",249,170,79,
"185",2015,"70-74",102,60,42,
"185",2015,"75-79",52,24,28,
"185",2015,"80-84",41,12,29,
"185",2015,"85-89",22,7,15,
"185",2015,"90+",6,4,2,
"188",2015,"0-4",798,441,357,
"188",2015,"5-9",836,413,423,
"188",2015,"10-14",705,356,349,
"188",2015,"15-19",649,338,311,
"188",2015,"20-24",612,327,285,
"188",2015,"25-29",705,378,327,
"188",2015,"30-34",578,312,266,
"188",2015,"35-39",407,219,188,
"188",2015,"40-44",392,201,191,
"188",2015,"45-49",407,256,151,
"188",2015,"50-54",508,283,225,
"188",2015,"55-59",426,248,178,
"188",2015,"60-64",302,193,109,
"188",2015,"65-69",221,110,111,
"188",2015,"70-74",133,73,60,
"188",2015,"75-79",82,44,38,
"188",2015,"80-84",64,21,43,
"188",2015,"85-89",49,11,38,
"188",2015,"90+",9,3,6,
"195",2015,"0-4",216,105,111,
"195",2015,"5-9",195,101,94,
"195",2015,"10-14",194,96,98,
"195",2015,"15-19",176,100,76,
"195",2015,"20-24",130,62,68,
"195",2015,"25-29",193,93,100,
"195",2015,"30-34",180,84,96,
"195",2015,"35-39",208,101,107,
"195",2015,"40-44",171,87,84,
"195",2015,"45-49",229,128,101,
"195",2015,"50-54",221,117,104,
"195",2015,"55-59",279,125,154,
"195",2015,"60-64",270,159,111,
"195",2015,"65-69",228,132,96,
"195",2015,"70-74",140,75,65,
"195",2015,"75-79",62,33,29,
"195",2015,"80-84",39,18,21,
"195",2015,"85-89",29,13,16,
"195",2015,"90+",21,9,12,
"198",2015,"0-4",416,215,201,
"198",2015,"5-9",512,254,258,
"198",2015,"10-14",451,242,209,
"198",2015,"15-19",381,213,168,
"198",2015,"20-24",321,189,132,
"198",2015,"25-29",367,191,176,
"198",2015,"30-34",393,207,186,
"198",2015,"35-39",381,206,175,
"198",2015,"40-44",382,197,185,
"198",2015,"45-49",437,239,198,
"198",2015,"50-54",548,309,239,
"198",2015,"55-59",562,310,252,
"198",2015,"60-64",497,274,223,
"198",2015,"65-69",395,242,153,
"198",2015,"70-74",231,134,97,
"198",2015,"75-79",140,88,52,
"198",2015,"80-84",65,31,34,
"198",2015,"85-89",25,11,14,
"198",2015,"90+",14,11,3,
"220",2015,"0-4",508,237,271,
"220",2015,"5-9",621,356,265,
"220",2015,"10-14",529,255,274,
"220",2015,"15-19",523,280,243,
"220",2015,"20-24",501,246,255,
"220",2015,"25-29",597,276,321,
"220",2015,"30-34",621,292,329,
"220",2015,"35-39",661,359,302,
"220",2015,"40-44",541,281,260,
"220",2015,"45-49",535,267,268,
"220",2015,"50-54",636,328,308,
"220",2015,"55-59",747,371,376,
"220",2015,"60-64",619,317,302,
"220",2015,"65-69",426,236,190,
"220",2015,"70-74",274,131,143,
"220",2015,"75-79",258,106,152,
"220",2015,"80-84",131,53,78,
"220",2015,"85-89",87,29,58,
"220",2015,"90+",66,14,52,
"230",2015,"0-4",59,25,34,
"230",2015,"5-9",49,30,19,
"230",2015,"10-14",32,14,18,
"230",2015,"15-19",22,8,14,
"230",2015,"20-24",50,23,27,
"230",2015,"25-29",70,26,44,
"230",2015,"30-34",110,54,56,
"230",2015,"35-39",79,42,37,
"230",2015,"40-44",95,55,40,
"230",2015,"45-49",102,49,53,
"230",2015,"50-54",73,43,30,
"230",2015,"55-59",75,44,31,
"230",2015,"60-64",93,53,40,
"230",2015,"65-69",66,32,34,
"230",2015,"70-74",29,12,17,
"230",2015,"75-79",18,6,12,
"230",2015,"80-84",17,5,12,
"230",2015,"85-89",3,1,2,
"230",2015,"90+",3,1,2,
"240",2015,"0-4",448,208,240,
"240",2015,"5-9",526,288,238,
"240",2015,"10-14",517,284,233,
"240",2015,"15-19",424,219,205,
"240",2015,"20-24",347,185,162,
"240",2015,"25-29",410,220,190,
"240",2015,"30-34",521,293,228,
"240",2015,"35-39",429,240,189,
"240",2015,"40-44",411,239,172,
"240",2015,"45-49",488,280,208,
"240",2015,"50-54",491,302,189,
"240",2015,"55-59",542,281,261,
"240",2015,"60-64",492,302,190,
"240",2015,"65-69",352,221,131,
"240",2015,"70-74",219,120,99,
"240",2015,"75-79",137,74,63,
"240",2015,"80-84",74,39,35,
"240",2015,"85-89",51,13,38,
"240",2015,"90+",20,6,14,
"275",2015,"0-4",142,72,70,
"275",2015,"5-9",143,56,87,
"275",2015,"10-14",132,72,60,
"275",2015,"15-19",125,70,55,
"275",2015,"20-24",115,64,51,
"275",2015,"25-29",158,61,97,
"275",2015,"30-34",129,72,57,
"275",2015,"35-39",88,42,46,
"275",2015,"40-44",110,55,55,
"275",2015,"45-49",141,74,67,
"275",2015,"50-54",191,88,103,
"275",2015,"55-59",266,142,124,
"275",2015,"60-64",236,115,121,
"275",2015,"65-69",176,106,70,
"275",2015,"70-74",115,56,59,
"275",2015,"75-79",101,64,37,
"275",2015,"80-84",43,19,24,
"275",2015,"85-89",19,6,13,
"275",2015,"90+",17,11,6,
"282",2015,"0-4",41,22,19,
"282",2015,"5-9",26,12,14,
"282",2015,"10-14",41,18,23,
"282",2015,"15-19",32,16,16,
"282",2015,"20-24",36,21,15,
"282",2015,"25-29",21,7,14,
"282",2015,"30-34",40,26,14,
"282",2015,"35-39",47,29,18,
"282",2015,"40-44",31,20,11,
"282",2015,"45-49",63,38,25,
"282",2015,"50-54",49,30,19,
"282",2015,"55-59",36,18,18,
"282",2015,"60-64",52,34,18,
"282",2015,"65-69",44,24,20,
"282",2015,"70-74",18,13,5,
"282",2015,"75-79",12,6,6,
"282",2015,"80-84",10,0,10,
"282",2015,"85-89",3,0,3,
"282",2015,"90+",3,1,2,
"290",2015,"0-4",429,214,215,
"290",2015,"5-9",470,254,216,
"290",2015,"10-14",367,190,177,
"290",2015,"15-19",424,224,200,
"290",2015,"20-24",291,150,141,
"290",2015,"25-29",388,205,183,
"290",2015,"30-34",351,195,156,
"290",2015,"35-39",341,182,159,
"290",2015,"40-44",251,137,114,
"290",2015,"45-49",269,131,138,
"290",2015,"50-54",384,207,177,
"290",2015,"55-59",438,237,201,
"290",2015,"60-64",404,243,161,
"290",2015,"65-69",283,149,134,
"290",2015,"70-74",169,98,71,
"290",2015,"75-79",94,57,37,
"290",2015,"80-84",82,37,45,
"290",2015,"85-89",40,22,18,
"290",2015,"90+",19,10,9,
"000",2016,"0-4",53040,27101,25939,
"000",2016,"5-9",54785,28292,26493,
"000",2016,"10-14",51304,26320,24984,
"000",2016,"15-19",48156,25354,22802,
"000",2016,"20-24",50670,27301,23369,
"000",2016,"25-29",57948,30235,27713,
"000",2016,"30-34",57754,29855,27899,
"000",2016,"35-39",49678,25690,23988,
"000",2016,"40-44",42828,22090,20738,
"000",2016,"45-49",44962,23169,21793,
"000",2016,"50-54",50319,26071,24248,
"000",2016,"55-59",53137,27385,25752,
"000",2016,"60-64",46957,24296,22661,
"000",2016,"65-69",33686,17743,15943,
"000",2016,"70-74",20055,10180,9875,
"000",2016,"75-79",11830,5859,5971,
"000",2016,"80-84",7229,3273,3956,
"000",2016,"85-89",4076,1643,2433,
"000",2016,"90+",2223,727,1496,
"013",2016,"0-4",75,36,39,
"013",2016,"5-9",96,40,56,
"013",2016,"10-14",64,32,32,
"013",2016,"15-19",85,50,35,
"013",2016,"20-24",201,143,58,
"013",2016,"25-29",215,162,53,
"013",2016,"30-34",272,201,71,
"013",2016,"35-39",307,207,100,
"013",2016,"40-44",255,176,79,
"013",2016,"45-49",325,255,70,
"013",2016,"50-54",353,232,121,
"013",2016,"55-59",359,216,143,
"013",2016,"60-64",185,129,56,
"013",2016,"65-69",95,58,37,
"013",2016,"70-74",63,37,26,
"013",2016,"75-79",28,19,9,
"013",2016,"80-84",9,4,5,
"013",2016,"85-89",14,11,3,
"013",2016,"90+",3,2,1,
"016",2016,"0-4",187,91,96,
"016",2016,"5-9",234,113,121,
"016",2016,"10-14",186,114,72,
"016",2016,"15-19",216,130,86,
"016",2016,"20-24",321,234,87,
"016",2016,"25-29",429,286,143,
"016",2016,"30-34",529,378,151,
"016",2016,"35-39",489,329,160,
"016",2016,"40-44",452,339,113,
"016",2016,"45-49",457,292,165,
"016",2016,"50-54",634,409,225,
"016",2016,"55-59",515,348,167,
"016",2016,"60-64",406,293,113,
"016",2016,"65-69",297,201,96,
"016",2016,"70-74",69,43,26,
"016",2016,"75-79",18,7,11,
"016",2016,"80-84",17,11,6,
"016",2016,"85-89",13,3,10,
"016",2016,"90+",2,2,0,
"020",2016,"0-4",21241,10885,10356,
"020",2016,"5-9",21322,10957,10365,
"020",2016,"10-14",20034,10291,9743,
"020",2016,"15-19",19204,9877,9327,
"020",2016,"20-24",22671,12005,10666,
"020",2016,"25-29",25671,13169,12502,
"020",2016,"30-34",24888,12550,12338,
"020",2016,"35-39",20672,10336,10336,
"020",2016,"40-44",17606,8810,8796,
"020",2016,"45-49",18305,9141,9164,
"020",2016,"50-54",19906,9822,10084,
"020",2016,"55-59",20186,10054,10132,
"020",2016,"60-64",17582,8812,8770,
"020",2016,"65-69",12557,6346,6211,
"020",2016,"70-74",7404,3572,3832,
"020",2016,"75-79",4503,2021,2482,
"020",2016,"80-84",2935,1272,1663,
"020",2016,"85-89",1631,619,1012,
"020",2016,"90+",1012,318,694,
"050",2016,"0-4",1821,953,868,
"050",2016,"5-9",1864,930,934,
"050",2016,"10-14",1729,886,843,
"050",2016,"15-19",1603,875,728,
"050",2016,"20-24",1410,689,721,
"050",2016,"25-29",1527,780,747,
"050",2016,"30-34",1278,655,623,
"050",2016,"35-39",983,494,489,
"050",2016,"40-44",838,430,408,
"050",2016,"45-49",912,495,417,
"050",2016,"50-54",1093,618,475,
"050",2016,"55-59",974,520,454,
"050",2016,"60-64",845,450,395,
"050",2016,"65-69",496,266,230,
"050",2016,"70-74",330,173,157,
"050",2016,"75-79",200,100,100,
"050",2016,"80-84",147,54,93,
"050",2016,"85-89",62,25,37,
"050",2016,"90+",15,6,9,
"060",2016,"0-4",39,19,20,
"060",2016,"5-9",30,16,14,
"060",2016,"10-14",48,23,25,
"060",2016,"15-19",64,33,31,
"060",2016,"20-24",41,24,17,
"060",2016,"25-29",66,33,33,
"060",2016,"30-34",55,29,26,
"060",2016,"35-39",34,18,16,
"060",2016,"40-44",64,36,28,
"060",2016,"45-49",68,37,31,
"060",2016,"50-54",74,40,34,
"060",2016,"55-59",107,64,43,
"060",2016,"60-64",82,50,32,
"060",2016,"65-69",47,19,28,
"060",2016,"70-74",23,17,6,
"060",2016,"75-79",20,7,13,
"060",2016,"80-84",7,5,2,
"060",2016,"85-89",5,3,2,
"060",2016,"90+",3,0,3,
"063",2016,"0-4",484,232,252,
"063",2016,"5-9",465,244,221,
"063",2016,"10-14",427,210,217,
"063",2016,"15-19",393,211,182,
"063",2016,"20-24",331,188,143,
"063",2016,"25-29",560,296,264,
"063",2016,"30-34",496,275,221,
"063",2016,"35-39",462,234,228,
"063",2016,"40-44",386,199,187,
"063",2016,"45-49",490,261,229,
"063",2016,"50-54",515,294,221,
"063",2016,"55-59",634,338,296,
"063",2016,"60-64",517,272,245,
"063",2016,"65-69",304,165,139,
"063",2016,"70-74",163,84,79,
"063",2016,"75-79",92,41,51,
"063",2016,"80-84",52,28,24,
"063",2016,"85-89",26,8,18,
"063",2016,"90+",10,1,9,
"066",2016,"0-4",173,77,96,
"066",2016,"5-9",200,101,99,
"066",2016,"10-14",185,93,92,
"066",2016,"15-19",168,84,84,
"066",2016,"20-24",104,61,43,
"066",2016,"25-29",117,60,57,
"066",2016,"30-34",156,77,79,
"066",2016,"35-39",150,80,70,
"066",2016,"40-44",96,43,53,
"066",2016,"45-49",196,112,84,
"066",2016,"50-54",203,100,103,
"066",2016,"55-59",300,155,145,
"066",2016,"60-64",268,168,100,
"066",2016,"65-69",169,102,67,
"066",2016,"70-74",97,51,46,
"066",2016,"75-79",81,48,33,
"066",2016,"80-84",21,11,10,
"066",2016,"85-89",13,5,8,
"066",2016,"90+",8,3,5,
"068",2016,"0-4",100,56,44,
"068",2016,"5-9",121,73,48,
"068",2016,"10-14",103,56,47,
"068",2016,"15-19",109,51,58,
"068",2016,"20-24",45,23,22,
"068",2016,"25-29",121,55,66,
"068",2016,"30-34",135,67,68,
"068",2016,"35-39",150,73,77,
"068",2016,"40-44",112,59,53,
"068",2016,"45-49",162,81,81,
"068",2016,"50-54",161,96,65,
"068",2016,"55-59",163,99,64,
"068",2016,"60-64",191,128,63,
"068",2016,"65-69",80,52,28,
"068",2016,"70-74",49,23,26,
"068",2016,"75-79",41,26,15,
"068",2016,"80-84",25,19,6,
"068",2016,"85-89",3,1,2,
"068",2016,"90+",1,1,0,
"070",2016,"0-4",460,191,269,
"070",2016,"5-9",483,258,225,
"070",2016,"10-14",377,190,187,
"070",2016,"15-19",392,207,185,
"070",2016,"20-24",384,199,185,
"070",2016,"25-29",411,225,186,
"070",2016,"30-34",310,154,156,
"070",2016,"35-39",273,135,138,
"070",2016,"40-44",206,108,98,
"070",2016,"45-49",263,132,131,
"070",2016,"50-54",333,179,154,
"070",2016,"55-59",353,204,149,
"070",2016,"60-64",298,162,136,
"070",2016,"65-69",146,70,76,
"070",2016,"70-74",127,68,59,
"070",2016,"75-79",79,45,34,
"070",2016,"80-84",41,20,21,
"070",2016,"85-89",17,9,8,
"070",2016,"90+",12,5,7,
"090",2016,"0-4",7274,3724,3550,
"090",2016,"5-9",7197,3790,3407,
"090",2016,"10-14",6432,3257,3175,
"090",2016,"15-19",6183,3311,2872,
"090",2016,"20-24",8827,5072,3755,
"090",2016,"25-29",8398,4525,3873,
"090",2016,"30-34",8299,4339,3960,
"090",2016,"35-39",6655,3450,3205,
"090",2016,"40-44",5781,3008,2773,
"090",2016,"45-49",5520,2862,2658,
"090",2016,"50-54",6229,3141,3088,
"090",2016,"55-59",6642,3380,3262,
"090",2016,"60-64",6016,3095,2921,
"090",2016,"65-69",4253,2271,1982,
"090",2016,"70-74",2568,1327,1241,
"090",2016,"75-79",1334,700,634,
"090",2016,"80-84",784,367,417,
"090",2016,"85-89",473,197,276,
"090",2016,"90+",233,64,169,
"100",2016,"0-4",99,39,60,
"100",2016,"5-9",156,74,82,
"100",2016,"10-14",119,67,52,
"100",2016,"15-19",110,54,56,
"100",2016,"20-24",70,37,33,
"100",2016,"25-29",119,65,54,
"100",2016,"30-34",157,78,79,
"100",2016,"35-39",149,73,76,
"100",2016,"40-44",121,58,63,
"100",2016,"45-49",150,78,72,
"100",2016,"50-54",199,108,91,
"100",2016,"55-59",256,125,131,
"100",2016,"60-64",262,132,130,
"100",2016,"65-69",215,107,108,
"100",2016,"70-74",125,61,64,
"100",2016,"75-79",67,30,37,
"100",2016,"80-84",40,14,26,
"100",2016,"85-89",34,12,22,
"100",2016,"90+",20,8,12,
"105",2016,"0-4",119,53,66,
"105",2016,"5-9",146,82,64,
"105",2016,"10-14",124,48,76,
"105",2016,"15-19",108,47,61,
"105",2016,"20-24",78,43,35,
"105",2016,"25-29",110,59,51,
"105",2016,"30-34",111,63,48,
"105",2016,"35-39",129,57,72,
"105",2016,"40-44",112,59,53,
"105",2016,"45-49",134,76,58,
"105",2016,"50-54",157,79,78,
"105",2016,"55-59",223,111,112,
"105",2016,"60-64",229,125,104,
"105",2016,"65-69",196,112,84,
"105",2016,"70-74",90,55,35,
"105",2016,"75-79",76,49,27,
"105",2016,"80-84",33,25,8,
"105",2016,"85-89",12,4,8,
"105",2016,"90+",3,2,1,
"110",2016,"0-4",1973,1022,951,
"110",2016,"5-9",2104,1047,1057,
"110",2016,"10-14",1996,1002,994,
"110",2016,"15-19",1974,1049,925,
"110",2016,"20-24",1834,941,893,
"110",2016,"25-29",2447,1213,1234,
"110",2016,"30-34",2681,1366,1315,
"110",2016,"35-39",2256,1170,1086,
"110",2016,"40-44",2034,1024,1010,
"110",2016,"45-49",2221,1147,1074,
"110",2016,"50-54",2460,1267,1193,
"110",2016,"55-59",2615,1331,1284,
"110",2016,"60-64",2321,1178,1143,
"110",2016,"65-69",1698,867,831,
"110",2016,"70-74",968,483,485,
"110",2016,"75-79",548,246,302,
"110",2016,"80-84",326,145,181,
"110",2016,"85-89",201,81,120,
"110",2016,"90+",90,29,61,
"122",2016,"0-4",3609,1793,1816,
"122",2016,"5-9",3747,1951,1796,
"122",2016,"10-14",3760,1896,1864,
"122",2016,"15-19",3522,1836,1686,
"122",2016,"20-24",2753,1552,1201,
"122",2016,"25-29",3485,1836,1649,
"122",2016,"30-34",3689,1938,1751,
"122",2016,"35-39",3604,1901,1703,
"122",2016,"40-44",3210,1678,1532,
"122",2016,"45-49",3577,1870,1707,
"122",2016,"50-54",4050,2082,1968,
"122",2016,"55-59",5007,2484,2523,
"122",2016,"60-64",4947,2585,2362,
"122",2016,"65-69",3763,2055,1708,
"122",2016,"70-74",2452,1325,1127,
"122",2016,"75-79",1396,744,652,
"122",2016,"80-84",836,401,435,
"122",2016,"85-89",445,198,247,
"122",2016,"90+",258,82,176,
"130",2016,"0-4",828,425,403,
"130",2016,"5-9",893,456,437,
"130",2016,"10-14",861,430,431,
"130",2016,"15-19",902,476,426,
"130",2016,"20-24",795,429,366,
"130",2016,"25-29",905,459,446,
"130",2016,"30-34",902,451,451,
"130",2016,"35-39",871,441,430,
"130",2016,"40-44",757,360,397,
"130",2016,"45-49",934,446,488,
"130",2016,"50-54",1011,539,472,
"130",2016,"55-59",1098,562,536,
"130",2016,"60-64",1056,517,539,
"130",2016,"65-69",789,400,389,
"130",2016,"70-74",522,257,265,
"130",2016,"75-79",300,175,125,
"130",2016,"80-84",162,75,87,
"130",2016,"85-89",129,62,67,
"130",2016,"90+",66,22,44,
"150",2016,"0-4",1017,526,491,
"150",2016,"5-9",1025,524,501,
"150",2016,"10-14",917,471,446,
"150",2016,"15-19",936,525,411,
"150",2016,"20-24",870,460,410,
"150",2016,"25-29",1141,645,496,
"150",2016,"30-34",1039,566,473,
"150",2016,"35-39",919,477,442,
"150",2016,"40-44",740,374,366,
"150",2016,"45-49",821,408,413,
"150",2016,"50-54",941,492,449,
"150",2016,"55-59",1030,593,437,
"150",2016,"60-64",815,446,369,
"150",2016,"65-69",585,268,317,
"150",2016,"70-74",368,196,172,
"150",2016,"75-79",186,99,87,
"150",2016,"80-84",114,47,67,
"150",2016,"85-89",59,21,38,
"150",2016,"90+",26,7,19,
"158",2016,"0-4",868,443,425,
"158",2016,"5-9",953,518,435,
"158",2016,"10-14",896,450,446,
"158",2016,"15-19",834,431,403,
"158",2016,"20-24",739,387,352,
"158",2016,"25-29",759,416,343,
"158",2016,"30-34",505,257,248,
"158",2016,"35-39",372,206,166,
"158",2016,"40-44",348,169,179,
"158",2016,"45-49",385,190,195,
"158",2016,"50-54",392,212,180,
"158",2016,"55-59",411,230,181,
"158",2016,"60-64",265,137,128,
"158",2016,"65-69",212,122,90,
"158",2016,"70-74",115,53,62,
"158",2016,"75-79",68,34,34,
"158",2016,"80-84",51,18,33,
"158",2016,"85-89",27,6,21,
"158",2016,"90+",10,4,6,
"164",2016,"0-4",152,76,76,
"164",2016,"5-9",135,78,57,
"164",2016,"10-14",118,57,61,
"164",2016,"15-19",111,53,58,
"164",2016,"20-24",115,61,54,
"164",2016,"25-29",130,72,58,
"164",2016,"30-34",135,61,74,
"164",2016,"35-39",124,67,57,
"164",2016,"40-44",68,37,31,
"164",2016,"45-49",60,32,28,
"164",2016,"50-54",124,67,57,
"164",2016,"55-59",122,71,51,
"164",2016,"60-64",102,52,50,
"164",2016,"65-69",62,38,24,
"164",2016,"70-74",42,22,20,
"164",2016,"75-79",18,9,9,
"164",2016,"80-84",12,7,5,
"164",2016,"85-89",8,3,5,
"164",2016,"90+",4,1,3,
"170",2016,"0-4",7852,4059,3793,
"170",2016,"5-9",8409,4337,4072,
"170",2016,"10-14",8350,4376,3974,
"170",2016,"15-19",7156,3822,3334,
"170",2016,"20-24",5503,2854,2649,
"170",2016,"25-29",6644,3402,3242,
"170",2016,"30-34",7408,3740,3668,
"170",2016,"35-39",7050,3634,3416,
"170",2016,"40-44",6255,3249,3006,
"170",2016,"45-49",6409,3270,3139,
"170",2016,"50-54",6963,3619,3344,
"170",2016,"55-59",7381,3831,3550,
"170",2016,"60-64",6396,3213,3183,
"170",2016,"65-69",4799,2503,2296,
"170",2016,"70-74",2857,1451,1406,
"170",2016,"75-79",1668,881,787,
"170",2016,"80-84",935,444,491,
"170",2016,"85-89",570,261,309,
"170",2016,"90+",234,81,153,
"180",2016,"0-4",939,476,463,
"180",2016,"5-9",1028,554,474,
"180",2016,"10-14",937,482,455,
"180",2016,"15-19",804,443,361,
"180",2016,"20-24",743,405,338,
"180",2016,"25-29",862,454,408,
"180",2016,"30-34",734,376,358,
"180",2016,"35-39",599,324,275,
"180",2016,"40-44",560,322,238,
"180",2016,"45-49",475,257,218,
"180",2016,"50-54",586,342,244,
"180",2016,"55-59",567,290,277,
"180",2016,"60-64",481,258,223,
"180",2016,"65-69",331,209,122,
"180",2016,"70-74",177,96,81,
"180",2016,"75-79",109,56,53,
"180",2016,"80-84",82,37,45,
"180",2016,"85-89",29,10,19,
"180",2016,"90+",11,6,5,
"185",2016,"0-4",713,362,351,
"185",2016,"5-9",739,386,353,
"185",2016,"10-14",673,349,324,
"185",2016,"15-19",554,305,249,
"185",2016,"20-24",587,337,250,
"185",2016,"25-29",880,529,351,
"185",2016,"30-34",992,670,322,
"185",2016,"35-39",721,499,222,
"185",2016,"40-44",522,328,194,
"185",2016,"45-49",527,355,172,
"185",2016,"50-54",978,699,279,
"185",2016,"55-59",843,587,256,
"185",2016,"60-64",594,389,205,
"185",2016,"65-69",257,173,84,
"185",2016,"70-74",105,61,44,
"185",2016,"75-79",49,21,28,
"185",2016,"80-84",49,17,32,
"185",2016,"85-89",20,5,15,
"185",2016,"90+",11,8,3,
"188",2016,"0-4",806,439,367,
"188",2016,"5-9",851,433,418,
"188",2016,"10-14",718,365,353,
"188",2016,"15-19",655,349,306,
"188",2016,"20-24",565,298,267,
"188",2016,"25-29",742,402,340,
"188",2016,"30-34",588,328,260,
"188",2016,"35-39",451,247,204,
"188",2016,"40-44",371,197,174,
"188",2016,"45-49",389,229,160,
"188",2016,"50-54",489,283,206,
"188",2016,"55-59",435,259,176,
"188",2016,"60-64",333,198,135,
"188",2016,"65-69",210,110,100,
"188",2016,"70-74",136,74,62,
"188",2016,"75-79",82,44,38,
"188",2016,"80-84",71,27,44,
"188",2016,"85-89",44,7,37,
"188",2016,"90+",11,3,8,
"195",2016,"0-4",217,101,116,
"195",2016,"5-9",205,106,99,
"195",2016,"10-14",194,99,95,
"195",2016,"15-19",166,95,71,
"195",2016,"20-24",120,58,62,
"195",2016,"25-29",195,90,105,
"195",2016,"30-34",194,95,99,
"195",2016,"35-39",210,101,109,
"195",2016,"40-44",156,72,84,
"195",2016,"45-49",230,131,99,
"195",2016,"50-54",205,112,93,
"195",2016,"55-59",260,120,140,
"195",2016,"60-64",283,157,126,
"195",2016,"65-69",246,145,101,
"195",2016,"70-74",132,73,59,
"195",2016,"75-79",77,40,37,
"195",2016,"80-84",35,20,15,
"195",2016,"85-89",28,12,16,
"195",2016,"90+",26,11,15,
"198",2016,"0-4",422,232,190,
"198",2016,"5-9",494,219,275,
"198",2016,"10-14",432,241,191,
"198",2016,"15-19",369,211,158,
"198",2016,"20-24",297,169,128,
"198",2016,"25-29",374,195,179,
"198",2016,"30-34",405,205,200,
"198",2016,"35-39",356,198,158,
"198",2016,"40-44",355,190,165,
"198",2016,"45-49",421,224,197,
"198",2016,"50-54",514,295,219,
"198",2016,"55-59",559,304,255,
"198",2016,"60-64",539,295,244,
"198",2016,"65-69",411,253,158,
"198",2016,"70-74",224,129,95,
"198",2016,"75-79",161,100,61,
"198",2016,"80-84",73,38,35,
"198",2016,"85-89",25,10,15,
"198",2016,"90+",14,11,3,
"220",2016,"0-4",493,241,252,
"220",2016,"5-9",614,342,272,
"220",2016,"10-14",547,271,276,
"220",2016,"15-19",527,288,239,
"220",2016,"20-24",488,241,247,
"220",2016,"25-29",604,288,316,
"220",2016,"30-34",617,275,342,
"220",2016,"35-39",697,391,306,
"220",2016,"40-44",540,279,261,
"220",2016,"45-49",542,273,269,
"220",2016,"50-54",590,303,287,
"220",2016,"55-59",715,354,361,
"220",2016,"60-64",644,325,319,
"220",2016,"65-69",475,258,217,
"220",2016,"70-74",271,129,142,
"220",2016,"75-79",257,110,147,
"220",2016,"80-84",136,49,87,
"220",2016,"85-89",75,34,41,
"220",2016,"90+",71,18,53,
"230",2016,"0-4",56,27,29,
"230",2016,"5-9",58,38,20,
"230",2016,"10-14",38,15,23,
"230",2016,"15-19",31,16,15,
"230",2016,"20-24",49,25,24,
"230",2016,"25-29",66,18,48,
"230",2016,"30-34",116,67,49,
"230",2016,"35-39",83,44,39,
"230",2016,"40-44",91,47,44,
"230",2016,"45-49",100,49,51,
"230",2016,"50-54",75,45,30,
"230",2016,"55-59",82,47,35,
"230",2016,"60-64",76,47,29,
"230",2016,"65-69",80,37,43,
"230",2016,"70-74",33,17,16,
"230",2016,"75-79",16,5,11,
"230",2016,"80-84",16,5,11,
"230",2016,"85-89",3,0,3,
"230",2016,"90+",3,1,2,
"240",2016,"0-4",434,215,219,
"240",2016,"5-9",545,293,252,
"240",2016,"10-14",495,269,226,
"240",2016,"15-19",427,224,203,
"240",2016,"20-24",330,165,165,
"240",2016,"25-29",408,227,181,
"240",2016,"30-34",543,298,245,
"240",2016,"35-39",450,252,198,
"240",2016,"40-44",387,227,160,
"240",2016,"45-49",444,251,193,
"240",2016,"50-54",482,275,207,
"240",2016,"55-59",568,317,251,
"240",2016,"60-64",489,285,204,
"240",2016,"65-69",390,246,144,
"240",2016,"70-74",218,122,96,
"240",2016,"75-79",152,77,75,
"240",2016,"80-84",86,53,33,
"240",2016,"85-89",51,11,40,
"240",2016,"90+",28,16,12,
"275",2016,"0-4",138,76,62,
"275",2016,"5-9",158,62,96,
"275",2016,"10-14",130,71,59,
"275",2016,"15-19",129,77,52,
"275",2016,"20-24",101,53,48,
"275",2016,"25-29",157,59,98,
"275",2016,"30-34",133,76,57,
"275",2016,"35-39",96,51,45,
"275",2016,"40-44",104,47,57,
"275",2016,"45-49",139,70,69,
"275",2016,"50-54",181,91,90,
"275",2016,"55-59",263,134,129,
"275",2016,"60-64",266,125,141,
"275",2016,"65-69",180,111,69,
"275",2016,"70-74",113,56,57,
"275",2016,"75-79",91,60,31,
"275",2016,"80-84",50,22,28,
"275",2016,"85-89",18,7,11,
"275",2016,"90+",12,5,7,
"282",2016,"0-4",37,21,16,
"282",2016,"5-9",30,11,19,
"282",2016,"10-14",36,17,19,
"282",2016,"15-19",32,15,17,
"282",2016,"20-24",32,17,15,
"282",2016,"25-29",27,13,14,
"282",2016,"30-34",37,24,13,
"282",2016,"35-39",44,26,18,
"282",2016,"40-44",25,18,7,
"282",2016,"45-49",60,30,30,
"282",2016,"50-54",43,28,15,
"282",2016,"55-59",43,24,19,
"282",2016,"60-64",55,34,21,
"282",2016,"65-69",40,19,21,
"282",2016,"70-74",22,14,8,
"282",2016,"75-79",14,8,6,
"282",2016,"80-84",9,0,9,
"282",2016,"85-89",3,0,3,
"282",2016,"90+",2,0,2,
"290",2016,"0-4",414,211,203,
"290",2016,"5-9",483,259,224,
"290",2016,"10-14",378,192,186,
"290",2016,"15-19",392,209,183,
"290",2016,"20-24",266,131,135,
"290",2016,"25-29",378,202,176,
"290",2016,"30-34",350,196,154,
"290",2016,"35-39",322,175,147,
"290",2016,"40-44",276,147,129,
"290",2016,"45-49",246,115,131,
"290",2016,"50-54",378,202,176,
"290",2016,"55-59",426,233,193,
"290",2016,"60-64",414,239,175,
"290",2016,"65-69",303,160,143,
"290",2016,"70-74",192,111,81,
"290",2016,"75-79",99,57,42,
"290",2016,"80-84",75,38,37,
"290",2016,"85-89",38,18,20,
"290",2016,"90+",24,10,14,
"000",2017,"0-4",52579,26730,25849,
"000",2017,"5-9",54272,27926,26346,
"000",2017,"10-14",52185,26763,25422,
"000",2017,"15-19",47843,25151,22692,
"000",2017,"20-24",48833,26368,22465,
"000",2017,"25-29",57449,29710,27739,
"000",2017,"30-34",57581,29722,27859,
"000",2017,"35-39",51015,26329,24686,
"000",2017,"40-44",42706,21860,20846,
"000",2017,"45-49",44169,22791,21378,
"000",2017,"50-54",47770,24666,23104,
"000",2017,"55-59",52261,26876,25385,
"000",2017,"60-64",47337,24218,23119,
"000",2017,"65-69",34438,18009,16429,
"000",2017,"70-74",21908,11232,10676,
"000",2017,"75-79",12601,6194,6407,
"000",2017,"80-84",7563,3439,4124,
"000",2017,"85-89",4142,1657,2485,
"000",2017,"90+",2268,770,1498,
"013",2017,"0-4",77,37,40,
"013",2017,"5-9",87,37,50,
"013",2017,"10-14",67,32,35,
"013",2017,"15-19",92,48,44,
"013",2017,"20-24",217,168,49,
"013",2017,"25-29",184,129,55,
"013",2017,"30-34",279,210,69,
"013",2017,"35-39",293,182,111,
"013",2017,"40-44",293,207,86,
"013",2017,"45-49",317,266,51,
"013",2017,"50-54",325,202,123,
"013",2017,"55-59",360,226,134,
"013",2017,"60-64",193,131,62,
"013",2017,"65-69",83,47,36,
"013",2017,"70-74",75,45,30,
"013",2017,"75-79",22,15,7,
"013",2017,"80-84",11,6,5,
"013",2017,"85-89",6,4,2,
"013",2017,"90+",3,1,2,
"016",2017,"0-4",198,96,102,
"016",2017,"5-9",216,102,114,
"016",2017,"10-14",188,114,74,
"016",2017,"15-19",230,139,91,
"016",2017,"20-24",270,179,91,
"016",2017,"25-29",471,339,132,
"016",2017,"30-34",507,362,145,
"016",2017,"35-39",458,290,168,
"016",2017,"40-44",438,328,110,
"016",2017,"45-49",443,272,171,
"016",2017,"50-54",601,377,224,
"016",2017,"55-59",522,362,160,
"016",2017,"60-64",379,268,111,
"016",2017,"65-69",303,201,102,
"016",2017,"70-74",82,54,28,
"016",2017,"75-79",20,10,10,
"016",2017,"80-84",14,7,7,
"016",2017,"85-89",11,5,6,
"016",2017,"90+",2,2,0,
"020",2017,"0-4",21037,10705,10332,
"020",2017,"5-9",21093,10776,10317,
"020",2017,"10-14",20182,10356,9826,
"020",2017,"15-19",19056,9795,9261,
"020",2017,"20-24",22041,11665,10376,
"020",2017,"25-29",25203,12847,12356,
"020",2017,"30-34",24669,12456,12213,
"020",2017,"35-39",21293,10605,10688,
"020",2017,"40-44",17385,8655,8730,
"020",2017,"45-49",18130,9049,9081,
"020",2017,"50-54",18934,9375,9559,
"020",2017,"55-59",19933,9915,10018,
"020",2017,"60-64",17850,8870,8980,
"020",2017,"65-69",12751,6334,6417,
"020",2017,"70-74",8058,3976,4082,
"020",2017,"75-79",4772,2148,2624,
"020",2017,"80-84",3061,1316,1745,
"020",2017,"85-89",1700,651,1049,
"020",2017,"90+",1028,332,696,
"050",2017,"0-4",1824,972,852,
"050",2017,"5-9",1871,961,910,
"050",2017,"10-14",1737,860,877,
"050",2017,"15-19",1630,888,742,
"050",2017,"20-24",1374,685,689,
"050",2017,"25-29",1556,766,790,
"050",2017,"30-34",1312,690,622,
"050",2017,"35-39",1009,511,498,
"050",2017,"40-44",837,419,418,
"050",2017,"45-49",870,473,397,
"050",2017,"50-54",1045,602,443,
"050",2017,"55-59",974,525,449,
"050",2017,"60-64",830,436,394,
"050",2017,"65-69",548,300,248,
"050",2017,"70-74",321,166,155,
"050",2017,"75-79",215,100,115,
"050",2017,"80-84",145,60,85,
"050",2017,"85-89",60,21,39,
"050",2017,"90+",15,6,9,
"060",2017,"0-4",52,21,31,
"060",2017,"5-9",42,25,17,
"060",2017,"10-14",44,21,23,
"060",2017,"15-19",67,32,35,
"060",2017,"20-24",44,25,19,
"060",2017,"25-29",61,28,33,
"060",2017,"30-34",53,31,22,
"060",2017,"35-39",32,16,16,
"060",2017,"40-44",56,33,23,
"060",2017,"45-49",65,32,33,
"060",2017,"50-54",65,38,27,
"060",2017,"55-59",107,61,46,
"060",2017,"60-64",95,59,36,
"060",2017,"65-69",49,19,30,
"060",2017,"70-74",20,14,6,
"060",2017,"75-79",27,12,15,
"060",2017,"80-84",7,4,3,
"060",2017,"85-89",5,3,2,
"060",2017,"90+",3,0,3,
"063",2017,"0-4",479,222,257,
"063",2017,"5-9",449,232,217,
"063",2017,"10-14",406,195,211,
"063",2017,"15-19",412,225,187,
"063",2017,"20-24",330,178,152,
"063",2017,"25-29",538,287,251,
"063",2017,"30-34",537,290,247,
"063",2017,"35-39",467,240,227,
"063",2017,"40-44",380,194,186,
"063",2017,"45-49",447,246,201,
"063",2017,"50-54",464,260,204,
"063",2017,"55-59",603,322,281,
"063",2017,"60-64",511,260,251,
"063",2017,"65-69",317,180,137,
"063",2017,"70-74",190,89,101,
"063",2017,"75-79",97,45,52,
"063",2017,"80-84",51,28,23,
"063",2017,"85-89",30,9,21,
"063",2017,"90+",11,1,10,
"066",2017,"0-4",177,73,104,
"066",2017,"5-9",188,103,85,
"066",2017,"10-14",189,83,106,
"066",2017,"15-19",169,86,83,
"066",2017,"20-24",104,56,48,
"066",2017,"25-29",118,60,58,
"066",2017,"30-34",158,75,83,
"066",2017,"35-39",166,88,78,
"066",2017,"40-44",118,56,62,
"066",2017,"45-49",165,95,70,
"066",2017,"50-54",203,106,97,
"066",2017,"55-59",263,139,124,
"066",2017,"60-64",274,162,112,
"066",2017,"65-69",172,105,67,
"066",2017,"70-74",99,59,40,
"066",2017,"75-79",80,45,35,
"066",2017,"80-84",24,17,7,
"066",2017,"85-89",14,4,10,
"066",2017,"90+",8,2,6,
"068",2017,"0-4",107,56,51,
"068",2017,"5-9",113,63,50,
"068",2017,"10-14",104,60,44,
"068",2017,"15-19",98,47,51,
"068",2017,"20-24",43,20,23,
"068",2017,"25-29",117,56,61,
"068",2017,"30-34",134,72,62,
"068",2017,"35-39",167,83,84,
"068",2017,"40-44",96,43,53,
"068",2017,"45-49",165,87,78,
"068",2017,"50-54",138,77,61,
"068",2017,"55-59",170,104,66,
"068",2017,"60-64",171,113,58,
"068",2017,"65-69",101,64,37,
"068",2017,"70-74",43,23,20,
"068",2017,"75-79",33,21,12,
"068",2017,"80-84",32,17,15,
"068",2017,"85-89",4,2,2,
"068",2017,"90+",0,0,0,
"070",2017,"0-4",465,198,267,
"070",2017,"5-9",479,251,228,
"070",2017,"10-14",386,198,188,
"070",2017,"15-19",361,196,165,
"070",2017,"20-24",359,183,176,
"070",2017,"25-29",443,248,195,
"070",2017,"30-34",314,149,165,
"070",2017,"35-39",268,136,132,
"070",2017,"40-44",215,110,105,
"070",2017,"45-49",211,108,103,
"070",2017,"50-54",324,173,151,
"070",2017,"55-59",359,198,161,
"070",2017,"60-64",291,163,128,
"070",2017,"65-69",179,88,91,
"070",2017,"70-74",118,58,60,
"070",2017,"75-79",79,52,27,
"070",2017,"80-84",52,25,27,
"070",2017,"85-89",19,10,9,
"070",2017,"90+",11,5,6,
"090",2017,"0-4",7108,3625,3483,
"090",2017,"5-9",7061,3697,3364,
"090",2017,"10-14",6543,3338,3205,
"090",2017,"15-19",6086,3259,2827,
"090",2017,"20-24",8268,4761,3507,
"090",2017,"25-29",8150,4291,3859,
"090",2017,"30-34",8190,4318,3872,
"090",2017,"35-39",6783,3564,3219,
"090",2017,"40-44",5723,2936,2787,
"090",2017,"45-49",5440,2798,2642,
"090",2017,"50-54",5899,2985,2914,
"090",2017,"55-59",6542,3305,3237,
"090",2017,"60-64",5984,3019,2965,
"090",2017,"65-69",4361,2332,2029,
"090",2017,"70-74",2873,1508,1365,
"090",2017,"75-79",1425,743,682,
"090",2017,"80-84",824,387,437,
"090",2017,"85-89",474,190,284,
"090",2017,"90+",241,90,151,
"100",2017,"0-4",91,35,56,
"100",2017,"5-9",160,83,77,
"100",2017,"10-14",122,63,59,
"100",2017,"15-19",110,53,57,
"100",2017,"20-24",63,38,25,
"100",2017,"25-29",111,56,55,
"100",2017,"30-34",154,74,80,
"100",2017,"35-39",149,72,77,
"100",2017,"40-44",142,72,70,
"100",2017,"45-49",148,77,71,
"100",2017,"50-54",186,98,88,
"100",2017,"55-59",245,124,121,
"100",2017,"60-64",264,129,135,
"100",2017,"65-69",211,106,105,
"100",2017,"70-74",141,68,73,
"100",2017,"75-79",71,32,39,
"100",2017,"80-84",41,16,25,
"100",2017,"85-89",36,13,23,
"100",2017,"90+",17,5,12,
"105",2017,"0-4",121,56,65,
"105",2017,"5-9",136,80,56,
"105",2017,"10-14",120,52,68,
"105",2017,"15-19",100,38,62,
"105",2017,"20-24",70,35,35,
"105",2017,"25-29",110,63,47,
"105",2017,"30-34",104,56,48,
"105",2017,"35-39",129,59,70,
"105",2017,"40-44",105,54,51,
"105",2017,"45-49",130,68,62,
"105",2017,"50-54",149,76,73,
"105",2017,"55-59",203,105,98,
"105",2017,"60-64",223,117,106,
"105",2017,"65-69",203,109,94,
"105",2017,"70-74",95,61,34,
"105",2017,"75-79",72,46,26,
"105",2017,"80-84",41,30,11,
"105",2017,"85-89",12,4,8,
"105",2017,"90+",4,4,0,
"110",2017,"0-4",1928,989,939,
"110",2017,"5-9",2006,1007,999,
"110",2017,"10-14",2028,1023,1005,
"110",2017,"15-19",1938,1033,905,
"110",2017,"20-24",1766,900,866,
"110",2017,"25-29",2422,1223,1199,
"110",2017,"30-34",2623,1323,1300,
"110",2017,"35-39",2312,1186,1126,
"110",2017,"40-44",1980,990,990,
"110",2017,"45-49",2149,1096,1053,
"110",2017,"50-54",2340,1196,1144,
"110",2017,"55-59",2526,1303,1223,
"110",2017,"60-64",2302,1152,1150,
"110",2017,"65-69",1755,893,862,
"110",2017,"70-74",1059,558,501,
"110",2017,"75-79",569,241,328,
"110",2017,"80-84",359,154,205,
"110",2017,"85-89",195,80,115,
"110",2017,"90+",90,23,67,
"122",2017,"0-4",3576,1792,1784,
"122",2017,"5-9",3742,1946,1796,
"122",2017,"10-14",3821,1947,1874,
"122",2017,"15-19",3503,1816,1687,
"122",2017,"20-24",2623,1476,1147,
"122",2017,"25-29",3543,1856,1687,
"122",2017,"30-34",3641,1904,1737,
"122",2017,"35-39",3731,1954,1777,
"122",2017,"40-44",3229,1696,1533,
"122",2017,"45-49",3467,1818,1649,
"122",2017,"50-54",3901,1991,1910,
"122",2017,"55-59",4848,2399,2449,
"122",2017,"60-64",4955,2541,2414,
"122",2017,"65-69",3824,2087,1737,
"122",2017,"70-74",2685,1439,1246,
"122",2017,"75-79",1551,805,746,
"122",2017,"80-84",847,417,430,
"122",2017,"85-89",432,195,237,
"122",2017,"90+",274,91,183,
"130",2017,"0-4",811,426,385,
"130",2017,"5-9",890,449,441,
"130",2017,"10-14",883,445,438,
"130",2017,"15-19",883,471,412,
"130",2017,"20-24",775,420,355,
"130",2017,"25-29",949,501,448,
"130",2017,"30-34",916,455,461,
"130",2017,"35-39",920,454,466,
"130",2017,"40-44",751,367,384,
"130",2017,"45-49",903,440,463,
"130",2017,"50-54",933,471,462,
"130",2017,"55-59",1101,578,523,
"130",2017,"60-64",1047,505,542,
"130",2017,"65-69",786,409,377,
"130",2017,"70-74",570,280,290,
"130",2017,"75-79",312,171,141,
"130",2017,"80-84",196,94,102,
"130",2017,"85-89",122,54,68,
"130",2017,"90+",65,22,43,
"150",2017,"0-4",1041,539,502,
"150",2017,"5-9",959,480,479,
"150",2017,"10-14",927,494,433,
"150",2017,"15-19",896,497,399,
"150",2017,"20-24",833,449,384,
"150",2017,"25-29",1064,588,476,
"150",2017,"30-34",1040,554,486,
"150",2017,"35-39",889,466,423,
"150",2017,"40-44",743,375,368,
"150",2017,"45-49",760,374,386,
"150",2017,"50-54",879,444,435,
"150",2017,"55-59",979,570,409,
"150",2017,"60-64",865,472,393,
"150",2017,"65-69",574,273,301,
"150",2017,"70-74",410,199,211,
"150",2017,"75-79",214,119,95,
"150",2017,"80-84",110,46,64,
"150",2017,"85-89",68,21,47,
"150",2017,"90+",30,8,22,
"158",2017,"0-4",867,437,430,
"158",2017,"5-9",945,515,430,
"158",2017,"10-14",948,483,465,
"158",2017,"15-19",783,395,388,
"158",2017,"20-24",738,403,335,
"158",2017,"25-29",770,392,378,
"158",2017,"30-34",541,287,254,
"158",2017,"35-39",385,223,162,
"158",2017,"40-44",344,171,173,
"158",2017,"45-49",355,175,180,
"158",2017,"50-54",386,201,185,
"158",2017,"55-59",403,220,183,
"158",2017,"60-64",289,154,135,
"158",2017,"65-69",194,111,83,
"158",2017,"70-74",117,57,60,
"158",2017,"75-79",74,41,33,
"158",2017,"80-84",55,18,37,
"158",2017,"85-89",26,7,19,
"158",2017,"90+",10,3,7,
"164",2017,"0-4",174,84,90,
"164",2017,"5-9",148,84,64,
"164",2017,"10-14",129,60,69,
"164",2017,"15-19",110,52,58,
"164",2017,"20-24",106,59,47,
"164",2017,"25-29",139,72,67,
"164",2017,"30-34",149,77,72,
"164",2017,"35-39",126,64,62,
"164",2017,"40-44",85,49,36,
"164",2017,"45-49",58,33,25,
"164",2017,"50-54",111,59,52,
"164",2017,"55-59",137,84,53,
"164",2017,"60-64",97,46,51,
"164",2017,"65-69",74,43,31,
"164",2017,"70-74",41,23,18,
"164",2017,"75-79",21,10,11,
"164",2017,"80-84",7,4,3,
"164",2017,"85-89",11,3,8,
"164",2017,"90+",2,0,2,
"170",2017,"0-4",7951,4103,3848,
"170",2017,"5-9",8492,4348,4144,
"170",2017,"10-14",8703,4517,4186,
"170",2017,"15-19",7251,3885,3366,
"170",2017,"20-24",5408,2835,2573,
"170",2017,"25-29",6740,3424,3316,
"170",2017,"30-34",7537,3728,3809,
"170",2017,"35-39",7316,3780,3536,
"170",2017,"40-44",6381,3249,3132,
"170",2017,"45-49",6518,3392,3126,
"170",2017,"50-54",6608,3381,3227,
"170",2017,"55-59",7421,3799,3622,
"170",2017,"60-64",6492,3276,3216,
"170",2017,"65-69",4986,2578,2408,
"170",2017,"70-74",3134,1596,1538,
"170",2017,"75-79",1834,970,864,
"170",2017,"80-84",994,471,523,
"170",2017,"85-89",595,269,326,
"170",2017,"90+",246,89,157,
"180",2017,"0-4",899,433,466,
"180",2017,"5-9",1056,568,488,
"180",2017,"10-14",949,491,458,
"180",2017,"15-19",778,417,361,
"180",2017,"20-24",701,390,311,
"180",2017,"25-29",892,439,453,
"180",2017,"30-34",748,385,363,
"180",2017,"35-39",626,343,283,
"180",2017,"40-44",541,303,238,
"180",2017,"45-49",466,244,222,
"180",2017,"50-54",569,327,242,
"180",2017,"55-59",554,285,269,
"180",2017,"60-64",493,256,237,
"180",2017,"65-69",340,207,133,
"180",2017,"70-74",175,98,77,
"180",2017,"75-79",108,53,55,
"180",2017,"80-84",80,37,43,
"180",2017,"85-89",25,8,17,
"180",2017,"90+",9,4,5,
"185",2017,"0-4",698,353,345,
"185",2017,"5-9",765,394,371,
"185",2017,"10-14",693,356,337,
"185",2017,"15-19",550,298,252,
"185",2017,"20-24",586,343,243,
"185",2017,"25-29",958,583,375,
"185",2017,"30-34",981,653,328,
"185",2017,"35-39",783,539,244,
"185",2017,"40-44",500,314,186,
"185",2017,"45-49",513,350,163,
"185",2017,"50-54",928,680,248,
"185",2017,"55-59",825,545,280,
"185",2017,"60-64",606,406,200,
"185",2017,"65-69",258,168,90,
"185",2017,"70-74",111,66,45,
"185",2017,"75-79",42,20,22,
"185",2017,"80-84",50,15,35,
"185",2017,"85-89",19,5,14,
"185",2017,"90+",10,8,2,
"188",2017,"0-4",759,401,358,
"188",2017,"5-9",841,434,407,
"188",2017,"10-14",740,378,362,
"188",2017,"15-19",643,343,300,
"188",2017,"20-24",537,272,265,
"188",2017,"25-29",730,389,341,
"188",2017,"30-34",615,351,264,
"188",2017,"35-39",464,243,221,
"188",2017,"40-44",359,189,170,
"188",2017,"45-49",368,217,151,
"188",2017,"50-54",478,285,193,
"188",2017,"55-59",426,245,181,
"188",2017,"60-64",346,206,140,
"188",2017,"65-69",220,123,97,
"188",2017,"70-74",147,73,74,
"188",2017,"75-79",73,38,35,
"188",2017,"80-84",65,26,39,
"188",2017,"85-89",41,7,34,
"188",2017,"90+",13,3,10,
"195",2017,"0-4",191,90,101,
"195",2017,"5-9",221,106,115,
"195",2017,"10-14",199,98,101,
"195",2017,"15-19",167,90,77,
"195",2017,"20-24",110,57,53,
"195",2017,"25-29",180,83,97,
"195",2017,"30-34",197,100,97,
"195",2017,"35-39",209,101,108,
"195",2017,"40-44",167,82,85,
"195",2017,"45-49",224,117,107,
"195",2017,"50-54",181,101,80,
"195",2017,"55-59",235,108,127,
"195",2017,"60-64",289,155,134,
"195",2017,"65-69",238,143,95,
"195",2017,"70-74",153,72,81,
"195",2017,"75-79",95,54,41,
"195",2017,"80-84",31,18,13,
"195",2017,"85-89",27,11,16,
"195",2017,"90+",27,12,15,
"198",2017,"0-4",408,236,172,
"198",2017,"5-9",501,221,280,
"198",2017,"10-14",417,235,182,
"198",2017,"15-19",372,215,157,
"198",2017,"20-24",270,151,119,
"198",2017,"25-29",374,195,179,
"198",2017,"30-34",418,209,209,
"198",2017,"35-39",382,211,171,
"198",2017,"40-44",338,181,157,
"198",2017,"45-49",391,212,179,
"198",2017,"50-54",489,280,209,
"198",2017,"55-59",548,294,254,
"198",2017,"60-64",516,268,248,
"198",2017,"65-69",428,272,156,
"198",2017,"70-74",242,139,103,
"198",2017,"75-79",175,105,70,
"198",2017,"80-84",75,42,33,
"198",2017,"85-89",22,8,14,
"198",2017,"90+",17,15,2,
"220",2017,"0-4",457,222,235,
"220",2017,"5-9",559,311,248,
"220",2017,"10-14",558,292,266,
"220",2017,"15-19",539,282,257,
"220",2017,"20-24",472,244,228,
"220",2017,"25-29",593,276,317,
"220",2017,"30-34",614,270,344,
"220",2017,"35-39",654,369,285,
"220",2017,"40-44",558,277,281,
"220",2017,"45-49",534,262,272,
"220",2017,"50-54",542,279,263,
"220",2017,"55-59",710,360,350,
"220",2017,"60-64",650,334,316,
"220",2017,"65-69",468,238,230,
"220",2017,"70-74",310,146,164,
"220",2017,"75-79",240,105,135,
"220",2017,"80-84",147,56,91,
"220",2017,"85-89",70,31,39,
"220",2017,"90+",71,18,53,
"230",2017,"0-4",70,32,38,
"230",2017,"5-9",50,32,18,
"230",2017,"10-14",42,20,22,
"230",2017,"15-19",33,15,18,
"230",2017,"20-24",42,22,20,
"230",2017,"25-29",61,22,39,
"230",2017,"30-34",113,64,49,
"230",2017,"35-39",86,48,38,
"230",2017,"40-44",101,43,58,
"230",2017,"45-49",102,54,48,
"230",2017,"50-54",76,39,37,
"230",2017,"55-59",72,41,31,
"230",2017,"60-64",86,51,35,
"230",2017,"65-69",81,38,43,
"230",2017,"70-74",36,21,15,
"230",2017,"75-79",23,5,18,
"230",2017,"80-84",13,4,9,
"230",2017,"85-89",3,1,2,
"230",2017,"90+",1,0,1,
"240",2017,"0-4",436,213,223,
"240",2017,"5-9",540,292,248,
"240",2017,"10-14",506,272,234,
"240",2017,"15-19",449,243,206,
"240",2017,"20-24",322,162,160,
"240",2017,"25-29",427,231,196,
"240",2017,"30-34",544,316,228,
"240",2017,"35-39",454,244,210,
"240",2017,"40-44",419,244,175,
"240",2017,"45-49",418,237,181,
"240",2017,"50-54",470,269,201,
"240",2017,"55-59",526,298,228,
"240",2017,"60-64",505,278,227,
"240",2017,"65-69",394,250,144,
"240",2017,"70-74",250,141,109,
"240",2017,"75-79",163,82,81,
"240",2017,"80-84",93,56,37,
"240",2017,"85-89",51,13,38,
"240",2017,"90+",26,12,14,
"275",2017,"0-4",134,70,64,
"275",2017,"5-9",163,69,94,
"275",2017,"10-14",126,60,66,
"275",2017,"15-19",131,76,55,
"275",2017,"20-24",86,49,37,
"275",2017,"25-29",146,58,88,
"275",2017,"30-34",123,60,63,
"275",2017,"35-39",105,60,45,
"275",2017,"40-44",100,44,56,
"275",2017,"45-49",132,70,62,
"275",2017,"50-54",162,79,83,
"275",2017,"55-59",240,124,116,
"275",2017,"60-64",264,126,138,
"275",2017,"65-69",186,107,79,
"275",2017,"70-74",127,68,59,
"275",2017,"75-79",84,49,35,
"275",2017,"80-84",49,25,24,
"275",2017,"85-89",22,9,13,
"275",2017,"90+",13,6,7,
"282",2017,"0-4",39,21,18,
"282",2017,"5-9",25,8,17,
"282",2017,"10-14",32,12,20,
"282",2017,"15-19",24,9,15,
"282",2017,"20-24",29,14,15,
"282",2017,"25-29",28,16,12,
"282",2017,"30-34",31,16,15,
"282",2017,"35-39",37,23,14,
"282",2017,"40-44",31,24,7,
"282",2017,"45-49",51,27,24,
"282",2017,"50-54",40,23,17,
"282",2017,"55-59",31,20,11,
"282",2017,"60-64",47,28,19,
"282",2017,"65-69",43,20,23,
"282",2017,"70-74",25,15,10,
"282",2017,"75-79",12,7,5,
"282",2017,"80-84",15,3,12,
"282",2017,"85-89",3,0,3,
"282",2017,"90+",1,0,1,
"290",2017,"0-4",404,193,211,
"290",2017,"5-9",474,252,222,
"290",2017,"10-14",396,208,188,
"290",2017,"15-19",382,208,174,
"290",2017,"20-24",246,129,117,
"290",2017,"25-29",371,192,179,
"290",2017,"30-34",339,187,152,
"290",2017,"35-39",322,175,147,
"290",2017,"40-44",291,155,136,
"290",2017,"45-49",229,102,127,
"290",2017,"50-54",344,192,152,
"290",2017,"55-59",398,217,181,
"290",2017,"60-64",423,237,186,
"290",2017,"65-69",311,164,147,
"290",2017,"70-74",201,120,81,
"290",2017,"75-79",98,50,48,
"290",2017,"80-84",74,40,34,
"290",2017,"85-89",39,19,20,
"290",2017,"90+",20,8,12,
"000",2018,"0-4",51106,25921,25185,
"000",2018,"5-9",53540,27546,25994,
"000",2018,"10-14",52555,27012,25543,
"000",2018,"15-19",47508,25035,22473,
"000",2018,"20-24",47355,25587,21768,
"000",2018,"25-29",56295,29312,26983,
"000",2018,"30-34",56787,29029,27758,
"000",2018,"35-39",52596,27209,25387,
"000",2018,"40-44",42928,22086,20842,
"000",2018,"45-49",43426,22258,21168,
"000",2018,"50-54",45146,23287,21859,
"000",2018,"55-59",51307,26427,24880,
"000",2018,"60-64",47623,24259,23364,
"000",2018,"65-69",36051,18805,17246,
"000",2018,"70-74",23177,11804,11373,
"000",2018,"75-79",13471,6682,6789,
"000",2018,"80-84",7926,3640,4286,
"000",2018,"85-89",4248,1687,2561,
"000",2018,"90+",2322,785,1537,
"013",2018,"0-4",73,41,32,
"013",2018,"5-9",81,36,45,
"013",2018,"10-14",65,33,32,
"013",2018,"15-19",89,47,42,
"013",2018,"20-24",216,164,52,
"013",2018,"25-29",148,96,52,
"013",2018,"30-34",227,163,64,
"013",2018,"35-39",333,205,128,
"013",2018,"40-44",302,218,84,
"013",2018,"45-49",281,224,57,
"013",2018,"50-54",345,213,132,
"013",2018,"55-59",387,262,125,
"013",2018,"60-64",189,117,72,
"013",2018,"65-69",97,59,38,
"013",2018,"70-74",79,46,33,
"013",2018,"75-79",22,14,8,
"013",2018,"80-84",17,10,7,
"013",2018,"85-89",3,2,1,
"013",2018,"90+",3,1,2,
"016",2018,"0-4",193,88,105,
"016",2018,"5-9",232,117,115,
"016",2018,"10-14",203,119,84,
"016",2018,"15-19",222,136,86,
"016",2018,"20-24",286,192,94,
"016",2018,"25-29",493,361,132,
"016",2018,"30-34",463,317,146,
"016",2018,"35-39",453,294,159,
"016",2018,"40-44",459,343,116,
"016",2018,"45-49",406,251,155,
"016",2018,"50-54",587,371,216,
"016",2018,"55-59",519,356,163,
"016",2018,"60-64",389,274,115,
"016",2018,"65-69",294,191,103,
"016",2018,"70-74",80,56,24,
"016",2018,"75-79",23,11,12,
"016",2018,"80-84",12,5,7,
"016",2018,"85-89",10,4,6,
"016",2018,"90+",2,2,0,
"020",2018,"0-4",20321,10257,10064,
"020",2018,"5-9",20635,10601,10034,
"020",2018,"10-14",20226,10387,9839,
"020",2018,"15-19",18774,9740,9034,
"020",2018,"20-24",21288,11207,10081,
"020",2018,"25-29",24567,12615,11952,
"020",2018,"30-34",24140,12172,11968,
"020",2018,"35-39",21779,10872,10907,
"020",2018,"40-44",17265,8642,8623,
"020",2018,"45-49",17839,8864,8975,
"020",2018,"50-54",17822,8815,9007,
"020",2018,"55-59",19711,9801,9910,
"020",2018,"60-64",17764,8708,9056,
"020",2018,"65-69",13243,6650,6593,
"020",2018,"70-74",8593,4206,4387,
"020",2018,"75-79",5037,2315,2722,
"020",2018,"80-84",3182,1359,1823,
"020",2018,"85-89",1742,677,1065,
"020",2018,"90+",1045,319,726,
"050",2018,"0-4",1751,917,834,
"050",2018,"5-9",1861,955,906,
"050",2018,"10-14",1747,864,883,
"050",2018,"15-19",1585,877,708,
"050",2018,"20-24",1375,689,686,
"050",2018,"25-29",1548,762,786,
"050",2018,"30-34",1333,700,633,
"050",2018,"35-39",1017,515,502,
"050",2018,"40-44",811,400,411,
"050",2018,"45-49",849,439,410,
"050",2018,"50-54",982,577,405,
"050",2018,"55-59",1008,544,464,
"050",2018,"60-64",842,447,395,
"050",2018,"65-69",606,331,275,
"050",2018,"70-74",323,168,155,
"050",2018,"75-79",217,101,116,
"050",2018,"80-84",133,58,75,
"050",2018,"85-89",58,14,44,
"050",2018,"90+",22,9,13,
"060",2018,"0-4",49,17,32,
"060",2018,"5-9",47,30,17,
"060",2018,"10-14",43,21,22,
"060",2018,"15-19",58,25,33,
"060",2018,"20-24",38,21,17,
"060",2018,"25-29",75,29,46,
"060",2018,"30-34",59,31,28,
"060",2018,"35-39",32,19,13,
"060",2018,"40-44",52,26,26,
"060",2018,"45-49",52,30,22,
"060",2018,"50-54",49,28,21,
"060",2018,"55-59",113,65,48,
"060",2018,"60-64",95,65,30,
"060",2018,"65-69",57,17,40,
"060",2018,"70-74",23,17,6,
"060",2018,"75-79",22,11,11,
"060",2018,"80-84",9,5,4,
"060",2018,"85-89",5,3,2,
"060",2018,"90+",1,0,1,
"063",2018,"0-4",484,248,236,
"063",2018,"5-9",455,227,228,
"063",2018,"10-14",418,210,208,
"063",2018,"15-19",396,219,177,
"063",2018,"20-24",300,155,145,
"063",2018,"25-29",528,294,234,
"063",2018,"30-34",553,306,247,
"063",2018,"35-39",486,253,233,
"063",2018,"40-44",399,202,197,
"063",2018,"45-49",406,219,187,
"063",2018,"50-54",454,250,204,
"063",2018,"55-59",576,306,270,
"063",2018,"60-64",527,272,255,
"063",2018,"65-69",334,181,153,
"063",2018,"70-74",213,110,103,
"063",2018,"75-79",99,46,53,
"063",2018,"80-84",47,25,22,
"063",2018,"85-89",32,10,22,
"063",2018,"90+",11,1,10,
"066",2018,"0-4",169,64,105,
"066",2018,"5-9",189,101,88,
"066",2018,"10-14",183,89,94,
"066",2018,"15-19",182,91,91,
"066",2018,"20-24",112,61,51,
"066",2018,"25-29",109,59,50,
"066",2018,"30-34",154,72,82,
"066",2018,"35-39",181,94,87,
"066",2018,"40-44",129,65,64,
"066",2018,"45-49",147,87,60,
"066",2018,"50-54",197,102,95,
"066",2018,"55-59",246,131,115,
"066",2018,"60-64",293,168,125,
"066",2018,"65-69",178,111,67,
"066",2018,"70-74",117,64,53,
"066",2018,"75-79",85,52,33,
"066",2018,"80-84",28,15,13,
"066",2018,"85-89",14,5,9,
"066",2018,"90+",7,3,4,
"068",2018,"0-4",94,49,45,
"068",2018,"5-9",112,65,47,
"068",2018,"10-14",102,57,45,
"068",2018,"15-19",93,39,54,
"068",2018,"20-24",46,22,24,
"068",2018,"25-29",114,58,56,
"068",2018,"30-34",131,61,70,
"068",2018,"35-39",145,71,74,
"068",2018,"40-44",121,66,55,
"068",2018,"45-49",168,84,84,
"068",2018,"50-54",135,78,57,
"068",2018,"55-59",172,103,69,
"068",2018,"60-64",152,96,56,
"068",2018,"65-69",125,80,45,
"068",2018,"70-74",48,28,20,
"068",2018,"75-79",31,19,12,
"068",2018,"80-84",26,9,17,
"068",2018,"85-89",9,7,2,
"068",2018,"90+",0,0,0,
"070",2018,"0-4",457,212,245,
"070",2018,"5-9",481,244,237,
"070",2018,"10-14",411,215,196,
"070",2018,"15-19",362,189,173,
"070",2018,"20-24",362,185,177,
"070",2018,"25-29",420,235,185,
"070",2018,"30-34",345,167,178,
"070",2018,"35-39",276,157,119,
"070",2018,"40-44",230,103,127,
"070",2018,"45-49",231,118,113,
"070",2018,"50-54",295,157,138,
"070",2018,"55-59",357,194,163,
"070",2018,"60-64",304,177,127,
"070",2018,"65-69",197,99,98,
"070",2018,"70-74",115,54,61,
"070",2018,"75-79",85,52,33,
"070",2018,"80-84",51,26,25,
"070",2018,"85-89",25,14,11,
"070",2018,"90+",10,3,7,
"090",2018,"0-4",6889,3515,3374,
"090",2018,"5-9",6856,3549,3307,
"090",2018,"10-14",6544,3379,3165,
"090",2018,"15-19",6181,3284,2897,
"090",2018,"20-24",8019,4639,3380,
"090",2018,"25-29",7837,4178,3659,
"090",2018,"30-34",7901,4112,3789,
"090",2018,"35-39",7031,3707,3324,
"090",2018,"40-44",5786,2977,2809,
"090",2018,"45-49",5338,2762,2576,
"090",2018,"50-54",5520,2768,2752,
"090",2018,"55-59",6371,3205,3166,
"090",2018,"60-64",6037,3032,3005,
"090",2018,"65-69",4550,2454,2096,
"090",2018,"70-74",2994,1531,1463,
"090",2018,"75-79",1551,808,743,
"090",2018,"80-84",866,401,465,
"090",2018,"85-89",468,187,281,
"090",2018,"90+",249,92,157,
"100",2018,"0-4",112,48,64,
"100",2018,"5-9",163,73,90,
"100",2018,"10-14",124,67,57,
"100",2018,"15-19",103,49,54,
"100",2018,"20-24",74,46,28,
"100",2018,"25-29",96,53,43,
"100",2018,"30-34",154,68,86,
"100",2018,"35-39",163,70,93,
"100",2018,"40-44",144,78,66,
"100",2018,"45-49",146,72,74,
"100",2018,"50-54",171,92,79,
"100",2018,"55-59",243,119,124,
"100",2018,"60-64",253,132,121,
"100",2018,"65-69",215,107,108,
"100",2018,"70-74",148,77,71,
"100",2018,"75-79",75,31,44,
"100",2018,"80-84",39,15,24,
"100",2018,"85-89",36,14,22,
"100",2018,"90+",17,6,11,
"105",2018,"0-4",122,54,68,
"105",2018,"5-9",135,79,56,
"105",2018,"10-14",136,60,76,
"105",2018,"15-19",103,41,62,
"105",2018,"20-24",72,38,34,
"105",2018,"25-29",114,67,47,
"105",2018,"30-34",110,60,50,
"105",2018,"35-39",135,68,67,
"105",2018,"40-44",116,54,62,
"105",2018,"45-49",115,63,52,
"105",2018,"50-54",149,77,72,
"105",2018,"55-59",183,97,86,
"105",2018,"60-64",214,113,101,
"105",2018,"65-69",212,106,106,
"105",2018,"70-74",105,72,33,
"105",2018,"75-79",85,50,35,
"105",2018,"80-84",48,34,14,
"105",2018,"85-89",9,3,6,
"105",2018,"90+",5,4,1,
"110",2018,"0-4",1898,953,945,
"110",2018,"5-9",1996,1030,966,
"110",2018,"10-14",2068,1048,1020,
"110",2018,"15-19",1930,1004,926,
"110",2018,"20-24",1682,882,800,
"110",2018,"25-29",2395,1196,1199,
"110",2018,"30-34",2563,1281,1282,
"110",2018,"35-39",2398,1221,1177,
"110",2018,"40-44",1991,995,996,
"110",2018,"45-49",2117,1095,1022,
"110",2018,"50-54",2215,1118,1097,
"110",2018,"55-59",2498,1298,1200,
"110",2018,"60-64",2266,1159,1107,
"110",2018,"65-69",1797,878,919,
"110",2018,"70-74",1164,637,527,
"110",2018,"75-79",589,245,344,
"110",2018,"80-84",378,169,209,
"110",2018,"85-89",188,77,111,
"110",2018,"90+",98,27,71,
"122",2018,"0-4",3525,1764,1761,
"122",2018,"5-9",3789,1973,1816,
"122",2018,"10-14",3809,1930,1879,
"122",2018,"15-19",3465,1805,1660,
"122",2018,"20-24",2589,1445,1144,
"122",2018,"25-29",3465,1831,1634,
"122",2018,"30-34",3644,1860,1784,
"122",2018,"35-39",3908,2062,1846,
"122",2018,"40-44",3245,1733,1512,
"122",2018,"45-49",3462,1794,1668,
"122",2018,"50-54",3661,1862,1799,
"122",2018,"55-59",4653,2330,2323,
"122",2018,"60-64",4940,2501,2439,
"122",2018,"65-69",4056,2211,1845,
"122",2018,"70-74",2757,1476,1281,
"122",2018,"75-79",1785,922,863,
"122",2018,"80-84",890,445,445,
"122",2018,"85-89",482,203,279,
"122",2018,"90+",262,91,171,
"130",2018,"0-4",764,396,368,
"130",2018,"5-9",885,464,421,
"130",2018,"10-14",915,447,468,
"130",2018,"15-19",889,472,417,
"130",2018,"20-24",768,418,350,
"130",2018,"25-29",928,482,446,
"130",2018,"30-34",941,455,486,
"130",2018,"35-39",945,482,463,
"130",2018,"40-44",789,389,400,
"130",2018,"45-49",864,415,449,
"130",2018,"50-54",871,433,438,
"130",2018,"55-59",1076,566,510,
"130",2018,"60-64",1049,527,522,
"130",2018,"65-69",811,406,405,
"130",2018,"70-74",594,283,311,
"130",2018,"75-79",363,204,159,
"130",2018,"80-84",213,110,103,
"130",2018,"85-89",106,43,63,
"130",2018,"90+",72,32,40,
"150",2018,"0-4",960,508,452,
"150",2018,"5-9",985,494,491,
"150",2018,"10-14",945,494,451,
"150",2018,"15-19",872,490,382,
"150",2018,"20-24",789,421,368,
"150",2018,"25-29",1046,571,475,
"150",2018,"30-34",1036,544,492,
"150",2018,"35-39",914,493,421,
"150",2018,"40-44",746,361,385,
"150",2018,"45-49",733,358,375,
"150",2018,"50-54",815,427,388,
"150",2018,"55-59",928,529,399,
"150",2018,"60-64",908,499,409,
"150",2018,"65-69",603,283,320,
"150",2018,"70-74",414,204,210,
"150",2018,"75-79",214,109,105,
"150",2018,"80-84",117,57,60,
"150",2018,"85-89",70,23,47,
"150",2018,"90+",26,8,18,
"158",2018,"0-4",893,455,438,
"158",2018,"5-9",952,507,445,
"158",2018,"10-14",910,469,441,
"158",2018,"15-19",806,405,401,
"158",2018,"20-24",722,399,323,
"158",2018,"25-29",773,398,375,
"158",2018,"30-34",579,316,263,
"158",2018,"35-39",409,226,183,
"158",2018,"40-44",340,165,175,
"158",2018,"45-49",344,165,179,
"158",2018,"50-54",379,197,182,
"158",2018,"55-59",405,218,187,
"158",2018,"60-64",307,169,138,
"158",2018,"65-69",207,119,88,
"158",2018,"70-74",138,64,74,
"158",2018,"75-79",65,35,30,
"158",2018,"80-84",52,21,31,
"158",2018,"85-89",31,9,22,
"158",2018,"90+",8,2,6,
"164",2018,"0-4",170,80,90,
"164",2018,"5-9",134,71,63,
"164",2018,"10-14",130,64,66,
"164",2018,"15-19",91,43,48,
"164",2018,"20-24",96,51,45,
"164",2018,"25-29",144,75,69,
"164",2018,"30-34",129,72,57,
"164",2018,"35-39",142,70,72,
"164",2018,"40-44",82,48,34,
"164",2018,"45-49",53,29,24,
"164",2018,"50-54",108,54,54,
"164",2018,"55-59",131,81,50,
"164",2018,"60-64",101,51,50,
"164",2018,"65-69",67,37,30,
"164",2018,"70-74",43,26,17,
"164",2018,"75-79",19,10,9,
"164",2018,"80-84",12,7,5,
"164",2018,"85-89",8,2,6,
"164",2018,"90+",2,0,2,
"170",2018,"0-4",7794,4037,3757,
"170",2018,"5-9",8544,4356,4188,
"170",2018,"10-14",8759,4534,4225,
"170",2018,"15-19",7248,3905,3343,
"170",2018,"20-24",5300,2798,2502,
"170",2018,"25-29",6834,3483,3351,
"170",2018,"30-34",7496,3669,3827,
"170",2018,"35-39",7655,3928,3727,
"170",2018,"40-44",6467,3350,3117,
"170",2018,"45-49",6414,3286,3128,
"170",2018,"50-54",6430,3289,3141,
"170",2018,"55-59",7324,3763,3561,
"170",2018,"60-64",6783,3447,3336,
"170",2018,"65-69",5360,2725,2635,
"170",2018,"70-74",3331,1665,1666,
"170",2018,"75-79",1993,1085,908,
"170",2018,"80-84",1067,504,563,
"170",2018,"85-89",611,286,325,
"170",2018,"90+",275,102,173,
"180",2018,"0-4",908,421,487,
"180",2018,"5-9",1019,562,457,
"180",2018,"10-14",944,486,458,
"180",2018,"15-19",801,436,365,
"180",2018,"20-24",684,377,307,
"180",2018,"25-29",883,460,423,
"180",2018,"30-34",750,375,375,
"180",2018,"35-39",633,349,284,
"180",2018,"40-44",569,313,256,
"180",2018,"45-49",472,243,229,
"180",2018,"50-54",504,294,210,
"180",2018,"55-59",567,285,282,
"180",2018,"60-64",497,265,232,
"180",2018,"65-69",324,193,131,
"180",2018,"70-74",198,120,78,
"180",2018,"75-79",101,47,54,
"180",2018,"80-84",83,36,47,
"180",2018,"85-89",24,8,16,
"180",2018,"90+",9,4,5,
"185",2018,"0-4",698,356,342,
"185",2018,"5-9",775,394,381,
"185",2018,"10-14",731,382,349,
"185",2018,"15-19",553,285,268,
"185",2018,"20-24",541,335,206,
"185",2018,"25-29",945,556,389,
"185",2018,"30-34",1040,690,350,
"185",2018,"35-39",822,574,248,
"185",2018,"40-44",531,319,212,
"185",2018,"45-49",525,359,166,
"185",2018,"50-54",837,621,216,
"185",2018,"55-59",803,522,281,
"185",2018,"60-64",588,389,199,
"185",2018,"65-69",284,183,101,
"185",2018,"70-74",120,72,48,
"185",2018,"75-79",46,19,27,
"185",2018,"80-84",50,24,26,
"185",2018,"85-89",19,4,15,
"185",2018,"90+",9,6,3,
"188",2018,"0-4",707,363,344,
"188",2018,"5-9",831,436,395,
"188",2018,"10-14",760,394,366,
"188",2018,"15-19",639,334,305,
"188",2018,"20-24",533,276,257,
"188",2018,"25-29",659,358,301,
"188",2018,"30-34",615,344,271,
"188",2018,"35-39",497,263,234,
"188",2018,"40-44",345,183,162,
"188",2018,"45-49",376,211,165,
"188",2018,"50-54",470,287,183,
"188",2018,"55-59",413,243,170,
"188",2018,"60-64",363,207,156,
"188",2018,"65-69",224,130,94,
"188",2018,"70-74",155,73,82,
"188",2018,"75-79",72,37,35,
"188",2018,"80-84",59,27,32,
"188",2018,"85-89",48,7,41,
"188",2018,"90+",13,2,11,
"195",2018,"0-4",202,91,111,
"195",2018,"5-9",223,104,119,
"195",2018,"10-14",203,104,99,
"195",2018,"15-19",170,84,86,
"195",2018,"20-24",118,67,51,
"195",2018,"25-29",174,73,101,
"195",2018,"30-34",206,99,107,
"195",2018,"35-39",205,103,102,
"195",2018,"40-44",172,80,92,
"195",2018,"45-49",226,116,110,
"195",2018,"50-54",178,102,76,
"195",2018,"55-59",235,109,126,
"195",2018,"60-64",273,141,132,
"195",2018,"65-69",246,148,98,
"195",2018,"70-74",172,80,92,
"195",2018,"75-79",97,57,40,
"195",2018,"80-84",43,22,21,
"195",2018,"85-89",28,11,17,
"195",2018,"90+",24,10,14,
"198",2018,"0-4",382,222,160,
"198",2018,"5-9",458,208,250,
"198",2018,"10-14",461,253,208,
"198",2018,"15-19",363,207,156,
"198",2018,"20-24",252,137,115,
"198",2018,"25-29",353,188,165,
"198",2018,"30-34",431,202,229,
"198",2018,"35-39",374,202,172,
"198",2018,"40-44",342,186,156,
"198",2018,"45-49",360,190,170,
"198",2018,"50-54",451,259,192,
"198",2018,"55-59",530,306,224,
"198",2018,"60-64",506,249,257,
"198",2018,"65-69",452,274,178,
"198",2018,"70-74",240,146,94,
"198",2018,"75-79",173,97,76,
"198",2018,"80-84",71,43,28,
"198",2018,"85-89",30,10,20,
"198",2018,"90+",10,8,2,
"220",2018,"0-4",446,236,210,
"220",2018,"5-9",508,277,231,
"220",2018,"10-14",570,310,260,
"220",2018,"15-19",542,282,260,
"220",2018,"20-24",426,210,216,
"220",2018,"25-29",603,291,312,
"220",2018,"30-34",630,275,355,
"220",2018,"35-39",608,332,276,
"220",2018,"40-44",558,289,269,
"220",2018,"45-49",529,258,271,
"220",2018,"50-54",524,263,261,
"220",2018,"55-59",658,350,308,
"220",2018,"60-64",661,325,336,
"220",2018,"65-69",477,235,242,
"220",2018,"70-74",334,165,169,
"220",2018,"75-79",217,97,120,
"220",2018,"80-84",182,71,111,
"220",2018,"85-89",76,26,50,
"220",2018,"90+",72,21,51,
"230",2018,"0-4",62,27,35,
"230",2018,"5-9",48,30,18,
"230",2018,"10-14",53,27,26,
"230",2018,"15-19",32,14,18,
"230",2018,"20-24",38,27,11,
"230",2018,"25-29",77,28,49,
"230",2018,"30-34",99,49,50,
"230",2018,"35-39",88,47,41,
"230",2018,"40-44",115,60,55,
"230",2018,"45-49",97,47,50,
"230",2018,"50-54",71,38,33,
"230",2018,"55-59",68,40,28,
"230",2018,"60-64",85,50,35,
"230",2018,"65-69",68,32,36,
"230",2018,"70-74",41,23,18,
"230",2018,"75-79",26,5,21,
"230",2018,"80-84",14,5,9,
"230",2018,"85-89",3,2,1,
"230",2018,"90+",2,0,2,
"240",2018,"0-4",445,224,221,
"240",2018,"5-9",507,264,243,
"240",2018,"10-14",507,266,241,
"240",2018,"15-19",440,239,201,
"240",2018,"20-24",292,151,141,
"240",2018,"25-29",450,251,199,
"240",2018,"30-34",538,299,239,
"240",2018,"35-39",480,266,214,
"240",2018,"40-44",413,233,180,
"240",2018,"45-49",455,274,181,
"240",2018,"50-54",432,242,190,
"240",2018,"55-59",503,273,230,
"240",2018,"60-64",498,281,217,
"240",2018,"65-69",386,249,137,
"240",2018,"70-74",275,147,128,
"240",2018,"75-79",171,91,80,
"240",2018,"80-84",94,57,37,
"240",2018,"85-89",49,14,35,
"240",2018,"90+",32,16,16,
"275",2018,"0-4",124,69,55,
"275",2018,"5-9",166,67,99,
"275",2018,"10-14",147,74,73,
"275",2018,"15-19",124,74,50,
"275",2018,"20-24",89,42,47,
"275",2018,"25-29",132,54,78,
"275",2018,"30-34",137,71,66,
"275",2018,"35-39",115,64,51,
"275",2018,"40-44",97,41,56,
"275",2018,"45-49",140,74,66,
"275",2018,"50-54",146,71,75,
"275",2018,"55-59",220,112,108,
"275",2018,"60-64",271,138,133,
"275",2018,"65-69",204,113,91,
"275",2018,"70-74",128,67,61,
"275",2018,"75-79",85,47,38,
"275",2018,"80-84",62,35,27,
"275",2018,"85-89",25,8,17,
"275",2018,"90+",11,6,5,
"282",2018,"0-4",35,18,17,
"282",2018,"5-9",26,10,16,
"282",2018,"10-14",31,14,17,
"282",2018,"15-19",27,10,17,
"282",2018,"20-24",17,10,7,
"282",2018,"25-29",31,20,11,
"282",2018,"30-34",23,10,13,
"282",2018,"35-39",41,24,17,
"282",2018,"40-44",28,20,8,
"282",2018,"45-49",45,25,20,
"282",2018,"50-54",50,33,17,
"282",2018,"55-59",26,16,10,
"282",2018,"60-64",45,25,20,
"282",2018,"65-69",39,21,18,
"282",2018,"70-74",26,14,12,
"282",2018,"75-79",10,7,3,
"282",2018,"80-84",16,6,10,
"282",2018,"85-89",4,0,4,
"282",2018,"90+",2,0,2,
"290",2018,"0-4",379,191,188,
"290",2018,"5-9",447,222,225,
"290",2018,"10-14",410,215,195,
"290",2018,"15-19",368,209,159,
"290",2018,"20-24",231,122,109,
"290",2018,"25-29",354,190,164,
"290",2018,"30-34",360,189,171,
"290",2018,"35-39",331,178,153,
"290",2018,"40-44",284,147,137,
"290",2018,"45-49",236,106,130,
"290",2018,"50-54",298,169,129,
"290",2018,"55-59",383,203,180,
"290",2018,"60-64",423,235,188,
"290",2018,"65-69",338,182,156,
"290",2018,"70-74",209,113,96,
"290",2018,"75-79",113,58,55,
"290",2018,"80-84",65,39,26,
"290",2018,"85-89",35,14,21,
"290",2018,"90+",23,10,13,
"000",2019,"0-4",49819,25447,24372,
"000",2019,"5-9",52633,26908,25725,
"000",2019,"10-14",52892,27414,25478,
"000",2019,"15-19",47072,24682,22390,
"000",2019,"20-24",46395,25286,21109,
"000",2019,"25-29",55160,28716,26444,
"000",2019,"30-34",57062,29076,27986,
"000",2019,"35-39",53411,27567,25844,
"000",2019,"40-44",43670,22590,21080,
"000",2019,"45-49",42002,21460,20542,
"000",2019,"50-54",43616,22513,21103,
"000",2019,"55-59",50105,25893,24212,
"000",2019,"60-64",47404,24023,23381,
"000",2019,"65-69",37365,19367,17998,
"000",2019,"70-74",24697,12602,12095,
"000",2019,"75-79",14487,7190,7297,
"000",2019,"80-84",8215,3841,4374,
"000",2019,"85-89",4339,1760,2579,
"000",2019,"90+",2390,811,1579,
"013",2019,"0-4",64,39,25,
"013",2019,"5-9",93,35,58,
"013",2019,"10-14",79,42,37,
"013",2019,"15-19",88,52,36,
"013",2019,"20-24",207,147,60,
"013",2019,"25-29",139,98,41,
"013",2019,"30-34",217,151,66,
"013",2019,"35-39",353,231,122,
"013",2019,"40-44",250,164,86,
"013",2019,"45-49",258,203,55,
"013",2019,"50-54",355,245,110,
"013",2019,"55-59",391,249,142,
"013",2019,"60-64",222,130,92,
"013",2019,"65-69",99,68,31,
"013",2019,"70-74",74,43,31,
"013",2019,"75-79",25,16,9,
"013",2019,"80-84",20,11,9,
"013",2019,"85-89",5,4,1,
"013",2019,"90+",2,1,1,
"016",2019,"0-4",195,101,94,
"016",2019,"5-9",246,118,128,
"016",2019,"10-14",237,133,104,
"016",2019,"15-19",221,143,78,
"016",2019,"20-24",299,198,101,
"016",2019,"25-29",568,450,118,
"016",2019,"30-34",472,298,174,
"016",2019,"35-39",473,309,164,
"016",2019,"40-44",465,326,139,
"016",2019,"45-49",396,260,136,
"016",2019,"50-54",598,363,235,
"016",2019,"55-59",544,365,179,
"016",2019,"60-64",432,312,120,
"016",2019,"65-69",293,194,99,
"016",2019,"70-74",105,68,37,
"016",2019,"75-79",19,11,8,
"016",2019,"80-84",12,4,8,
"016",2019,"85-89",9,5,4,
"016",2019,"90+",1,1,0,
"020",2019,"0-4",19699,10055,9644,
"020",2019,"5-9",20060,10267,9793,
"020",2019,"10-14",20136,10487,9649,
"020",2019,"15-19",18532,9533,8999,
"020",2019,"20-24",20740,10967,9773,
"020",2019,"25-29",24030,12376,11654,
"020",2019,"30-34",24242,12174,12068,
"020",2019,"35-39",21925,10953,10972,
"020",2019,"40-44",17505,8763,8742,
"020",2019,"45-49",17175,8483,8692,
"020",2019,"50-54",17202,8525,8677,
"020",2019,"55-59",19337,9681,9656,
"020",2019,"60-64",17672,8639,9033,
"020",2019,"65-69",13639,6822,6817,
"020",2019,"70-74",9115,4454,4661,
"020",2019,"75-79",5365,2487,2878,
"020",2019,"80-84",3287,1424,1863,
"020",2019,"85-89",1748,706,1042,
"020",2019,"90+",1078,330,748,
"050",2019,"0-4",1718,913,805,
"050",2019,"5-9",1848,940,908,
"050",2019,"10-14",1760,871,889,
"050",2019,"15-19",1583,848,735,
"050",2019,"20-24",1390,735,655,
"050",2019,"25-29",1524,761,763,
"050",2019,"30-34",1362,705,657,
"050",2019,"35-39",1062,548,514,
"050",2019,"40-44",860,441,419,
"050",2019,"45-49",858,442,416,
"050",2019,"50-54",911,514,397,
"050",2019,"55-59",1036,570,466,
"050",2019,"60-64",848,437,411,
"050",2019,"65-69",649,363,286,
"050",2019,"70-74",323,172,151,
"050",2019,"75-79",248,122,126,
"050",2019,"80-84",118,57,61,
"050",2019,"85-89",61,14,47,
"050",2019,"90+",17,5,12,
"060",2019,"0-4",56,24,32,
"060",2019,"5-9",50,29,21,
"060",2019,"10-14",40,19,21,
"060",2019,"15-19",56,25,31,
"060",2019,"20-24",42,25,17,
"060",2019,"25-29",59,25,34,
"060",2019,"30-34",71,29,42,
"060",2019,"35-39",46,25,21,
"060",2019,"40-44",43,26,17,
"060",2019,"45-49",57,31,26,
"060",2019,"50-54",41,23,18,
"060",2019,"55-59",94,51,43,
"060",2019,"60-64",94,63,31,
"060",2019,"65-69",59,22,37,
"060",2019,"70-74",24,15,9,
"060",2019,"75-79",21,11,10,
"060",2019,"80-84",11,7,4,
"060",2019,"85-89",6,4,2,
"060",2019,"90+",1,0,1,
"063",2019,"0-4",486,247,239,
"063",2019,"5-9",448,229,219,
"063",2019,"10-14",448,230,218,
"063",2019,"15-19",393,214,179,
"063",2019,"20-24",290,165,125,
"063",2019,"25-29",518,273,245,
"063",2019,"30-34",570,315,255,
"063",2019,"35-39",502,255,247,
"063",2019,"40-44",423,230,193,
"063",2019,"45-49",389,197,192,
"063",2019,"50-54",422,239,183,
"063",2019,"55-59",532,287,245,
"063",2019,"60-64",522,270,252,
"063",2019,"65-69",371,197,174,
"063",2019,"70-74",216,110,106,
"063",2019,"75-79",125,63,62,
"063",2019,"80-84",52,24,28,
"063",2019,"85-89",32,13,19,
"063",2019,"90+",11,1,10,
"066",2019,"0-4",186,83,103,
"066",2019,"5-9",185,96,89,
"066",2019,"10-14",199,93,106,
"066",2019,"15-19",167,85,82,
"066",2019,"20-24",107,62,45,
"066",2019,"25-29",108,60,48,
"066",2019,"30-34",171,78,93,
"066",2019,"35-39",185,98,87,
"066",2019,"40-44",140,72,68,
"066",2019,"45-49",136,77,59,
"066",2019,"50-54",189,97,92,
"066",2019,"55-59",236,125,111,
"066",2019,"60-64",311,176,135,
"066",2019,"65-69",186,114,72,
"066",2019,"70-74",120,66,54,
"066",2019,"75-79",96,62,34,
"066",2019,"80-84",32,17,15,
"066",2019,"85-89",12,4,8,
"066",2019,"90+",4,3,1,
"068",2019,"0-4",103,52,51,
"068",2019,"5-9",115,64,51,
"068",2019,"10-14",113,57,56,
"068",2019,"15-19",98,44,54,
"068",2019,"20-24",46,21,25,
"068",2019,"25-29",108,56,52,
"068",2019,"30-34",148,71,77,
"068",2019,"35-39",153,77,76,
"068",2019,"40-44",124,64,60,
"068",2019,"45-49",156,76,80,
"068",2019,"50-54",132,80,52,
"068",2019,"55-59",168,101,67,
"068",2019,"60-64",152,98,54,
"068",2019,"65-69",126,76,50,
"068",2019,"70-74",46,27,19,
"068",2019,"75-79",38,25,13,
"068",2019,"80-84",27,8,19,
"068",2019,"85-89",8,6,2,
"068",2019,"90+",2,2,0,
"070",2019,"0-4",446,215,231,
"070",2019,"5-9",474,234,240,
"070",2019,"10-14",417,223,194,
"070",2019,"15-19",338,179,159,
"070",2019,"20-24",335,174,161,
"070",2019,"25-29",410,228,182,
"070",2019,"30-34",325,157,168,
"070",2019,"35-39",303,156,147,
"070",2019,"40-44",197,97,100,
"070",2019,"45-49",221,107,114,
"070",2019,"50-54",286,151,135,
"070",2019,"55-59",330,180,150,
"070",2019,"60-64",330,192,138,
"070",2019,"65-69",204,107,97,
"070",2019,"70-74",110,50,60,
"070",2019,"75-79",87,51,36,
"070",2019,"80-84",55,27,28,
"070",2019,"85-89",20,7,13,
"070",2019,"90+",10,5,5,
"090",2019,"0-4",6774,3459,3315,
"090",2019,"5-9",6708,3454,3254,
"090",2019,"10-14",6452,3335,3117,
"090",2019,"15-19",6070,3219,2851,
"090",2019,"20-24",7937,4639,3298,
"090",2019,"25-29",7762,4119,3643,
"090",2019,"30-34",7926,4131,3795,
"090",2019,"35-39",7161,3747,3414,
"090",2019,"40-44",5740,2987,2753,
"090",2019,"45-49",5163,2697,2466,
"090",2019,"50-54",5239,2665,2574,
"090",2019,"55-59",6192,3095,3097,
"090",2019,"60-64",5860,2981,2879,
"090",2019,"65-69",4635,2426,2209,
"090",2019,"70-74",3199,1666,1533,
"090",2019,"75-79",1682,863,819,
"090",2019,"80-84",858,411,447,
"090",2019,"85-89",472,188,284,
"090",2019,"90+",265,98,167,
"100",2019,"0-4",121,58,63,
"100",2019,"5-9",163,73,90,
"100",2019,"10-14",128,72,56,
"100",2019,"15-19",112,56,56,
"100",2019,"20-24",77,45,32,
"100",2019,"25-29",108,57,51,
"100",2019,"30-34",138,63,75,
"100",2019,"35-39",175,80,95,
"100",2019,"40-44",142,73,69,
"100",2019,"45-49",137,71,66,
"100",2019,"50-54",158,80,78,
"100",2019,"55-59",257,130,127,
"100",2019,"60-64",264,135,129,
"100",2019,"65-69",217,112,105,
"100",2019,"70-74",150,75,75,
"100",2019,"75-79",87,37,50,
"100",2019,"80-84",39,18,21,
"100",2019,"85-89",33,10,23,
"100",2019,"90+",18,5,13,
"105",2019,"0-4",114,49,65,
"105",2019,"5-9",127,66,61,
"105",2019,"10-14",140,65,75,
"105",2019,"15-19",100,44,56,
"105",2019,"20-24",69,33,36,
"105",2019,"25-29",112,69,43,
"105",2019,"30-34",110,62,48,
"105",2019,"35-39",126,62,64,
"105",2019,"40-44",114,54,60,
"105",2019,"45-49",119,64,55,
"105",2019,"50-54",135,75,60,
"105",2019,"55-59",187,97,90,
"105",2019,"60-64",207,108,99,
"105",2019,"65-69",225,119,106,
"105",2019,"70-74",114,70,44,
"105",2019,"75-79",83,54,29,
"105",2019,"80-84",54,37,17,
"105",2019,"85-89",14,6,8,
"105",2019,"90+",5,4,1,
"110",2019,"0-4",1757,872,885,
"110",2019,"5-9",1985,1013,972,
"110",2019,"10-14",2105,1066,1039,
"110",2019,"15-19",1886,980,906,
"110",2019,"20-24",1631,849,782,
"110",2019,"25-29",2353,1183,1170,
"110",2019,"30-34",2555,1283,1272,
"110",2019,"35-39",2483,1248,1235,
"110",2019,"40-44",2037,1016,1021,
"110",2019,"45-49",1976,1018,958,
"110",2019,"50-54",2190,1100,1090,
"110",2019,"55-59",2398,1232,1166,
"110",2019,"60-64",2245,1144,1101,
"110",2019,"65-69",1851,902,949,
"110",2019,"70-74",1265,679,586,
"110",2019,"75-79",648,285,363,
"110",2019,"80-84",407,179,228,
"110",2019,"85-89",179,71,108,
"110",2019,"90+",108,32,76,
"122",2019,"0-4",3476,1751,1725,
"122",2019,"5-9",3731,1896,1835,
"122",2019,"10-14",3880,1997,1883,
"122",2019,"15-19",3433,1784,1649,
"122",2019,"20-24",2508,1411,1097,
"122",2019,"25-29",3418,1816,1602,
"122",2019,"30-34",3666,1865,1801,
"122",2019,"35-39",3930,2087,1843,
"122",2019,"40-44",3439,1856,1583,
"122",2019,"45-49",3367,1694,1673,
"122",2019,"50-54",3551,1849,1702,
"122",2019,"55-59",4453,2231,2222,
"122",2019,"60-64",4817,2411,2406,
"122",2019,"65-69",4249,2267,1982,
"122",2019,"70-74",2924,1551,1373,
"122",2019,"75-79",1946,1008,938,
"122",2019,"80-84",928,472,456,
"122",2019,"85-89",511,229,282,
"122",2019,"90+",272,92,180,
"130",2019,"0-4",736,380,356,
"130",2019,"5-9",900,480,420,
"130",2019,"10-14",898,446,452,
"130",2019,"15-19",867,462,405,
"130",2019,"20-24",755,414,341,
"130",2019,"25-29",945,503,442,
"130",2019,"30-34",931,447,484,
"130",2019,"35-39",971,492,479,
"130",2019,"40-44",813,414,399,
"130",2019,"45-49",809,398,411,
"130",2019,"50-54",864,419,445,
"130",2019,"55-59",1050,550,500,
"130",2019,"60-64",1030,503,527,
"130",2019,"65-69",838,429,409,
"130",2019,"70-74",606,284,322,
"130",2019,"75-79",396,210,186,
"130",2019,"80-84",217,112,105,
"130",2019,"85-89",101,41,60,
"130",2019,"90+",71,31,40,
"150",2019,"0-4",938,491,447,
"150",2019,"5-9",950,495,455,
"150",2019,"10-14",984,510,474,
"150",2019,"15-19",837,464,373,
"150",2019,"20-24",813,451,362,
"150",2019,"25-29",1004,525,479,
"150",2019,"30-34",1018,561,457,
"150",2019,"35-39",920,478,442,
"150",2019,"40-44",771,386,385,
"150",2019,"45-49",709,358,351,
"150",2019,"50-54",759,383,376,
"150",2019,"55-59",913,506,407,
"150",2019,"60-64",877,492,385,
"150",2019,"65-69",623,301,322,
"150",2019,"70-74",444,212,232,
"150",2019,"75-79",242,123,119,
"150",2019,"80-84",124,58,66,
"150",2019,"85-89",68,24,44,
"150",2019,"90+",35,9,26,
"158",2019,"0-4",884,473,411,
"158",2019,"5-9",908,466,442,
"158",2019,"10-14",930,491,439,
"158",2019,"15-19",786,392,394,
"158",2019,"20-24",691,392,299,
"158",2019,"25-29",719,363,356,
"158",2019,"30-34",619,343,276,
"158",2019,"35-39",413,221,192,
"158",2019,"40-44",321,154,167,
"158",2019,"45-49",319,153,166,
"158",2019,"50-54",361,187,174,
"158",2019,"55-59",407,215,192,
"158",2019,"60-64",323,173,150,
"158",2019,"65-69",217,119,98,
"158",2019,"70-74",149,78,71,
"158",2019,"75-79",66,30,36,
"158",2019,"80-84",36,14,22,
"158",2019,"85-89",43,11,32,
"158",2019,"90+",7,3,4,
"164",2019,"0-4",155,77,78,
"164",2019,"5-9",133,70,63,
"164",2019,"10-14",127,61,66,
"164",2019,"15-19",104,49,55,
"164",2019,"20-24",93,44,49,
"164",2019,"25-29",120,61,59,
"164",2019,"30-34",135,74,61,
"164",2019,"35-39",123,52,71,
"164",2019,"40-44",86,54,32,
"164",2019,"45-49",59,33,26,
"164",2019,"50-54",89,46,43,
"164",2019,"55-59",125,77,48,
"164",2019,"60-64",108,53,55,
"164",2019,"65-69",82,46,36,
"164",2019,"70-74",35,22,13,
"164",2019,"75-79",22,11,11,
"164",2019,"80-84",18,11,7,
"164",2019,"85-89",10,2,8,
"164",2019,"90+",1,0,1,
"170",2019,"0-4",7665,3965,3700,
"170",2019,"5-9",8657,4411,4246,
"170",2019,"10-14",8819,4557,4262,
"170",2019,"15-19",7443,3994,3449,
"170",2019,"20-24",5128,2738,2390,
"170",2019,"25-29",6745,3388,3357,
"170",2019,"30-34",7589,3729,3860,
"170",2019,"35-39",7828,4006,3822,
"170",2019,"40-44",6660,3493,3167,
"170",2019,"45-49",6333,3218,3115,
"170",2019,"50-54",6332,3232,3100,
"170",2019,"55-59",7167,3704,3463,
"170",2019,"60-64",6893,3446,3447,
"170",2019,"65-69",5671,2887,2784,
"170",2019,"70-74",3652,1860,1792,
"170",2019,"75-79",2135,1129,1006,
"170",2019,"80-84",1135,562,573,
"170",2019,"85-89",653,296,357,
"170",2019,"90+",277,106,171,
"180",2019,"0-4",852,397,455,
"180",2019,"5-9",952,505,447,
"180",2019,"10-14",990,536,454,
"180",2019,"15-19",808,434,374,
"180",2019,"20-24",652,354,298,
"180",2019,"25-29",821,421,400,
"180",2019,"30-34",780,394,386,
"180",2019,"35-39",639,338,301,
"180",2019,"40-44",563,302,261,
"180",2019,"45-49",477,249,228,
"180",2019,"50-54",491,291,200,
"180",2019,"55-59",529,266,263,
"180",2019,"60-64",510,265,245,
"180",2019,"65-69",347,192,155,
"180",2019,"70-74",216,137,79,
"180",2019,"75-79",102,41,61,
"180",2019,"80-84",81,38,43,
"180",2019,"85-89",30,17,13,
"180",2019,"90+",10,3,7,
"185",2019,"0-4",656,334,322,
"185",2019,"5-9",785,396,389,
"185",2019,"10-14",774,401,373,
"185",2019,"15-19",575,299,276,
"185",2019,"20-24",557,335,222,
"185",2019,"25-29",870,508,362,
"185",2019,"30-34",1001,651,350,
"185",2019,"35-39",864,603,261,
"185",2019,"40-44",552,336,216,
"185",2019,"45-49",559,383,176,
"185",2019,"50-54",779,560,219,
"185",2019,"55-59",795,540,255,
"185",2019,"60-64",581,377,204,
"185",2019,"65-69",318,203,115,
"185",2019,"70-74",125,75,50,
"185",2019,"75-79",47,24,23,
"185",2019,"80-84",42,15,27,
"185",2019,"85-89",17,5,12,
"185",2019,"90+",7,6,1,
"188",2019,"0-4",701,350,351,
"188",2019,"5-9",804,415,389,
"188",2019,"10-14",795,426,369,
"188",2019,"15-19",621,331,290,
"188",2019,"20-24",537,287,250,
"188",2019,"25-29",599,319,280,
"188",2019,"30-34",644,357,287,
"188",2019,"35-39",493,264,229,
"188",2019,"40-44",372,195,177,
"188",2019,"45-49",343,185,158,
"188",2019,"50-54",439,276,163,
"188",2019,"55-59",435,248,187,
"188",2019,"60-64",364,199,165,
"188",2019,"65-69",216,129,87,
"188",2019,"70-74",177,91,86,
"188",2019,"75-79",69,33,36,
"188",2019,"80-84",62,35,27,
"188",2019,"85-89",47,9,38,
"188",2019,"90+",12,2,10,
"195",2019,"0-4",191,97,94,
"195",2019,"5-9",229,95,134,
"195",2019,"10-14",210,108,102,
"195",2019,"15-19",156,75,81,
"195",2019,"20-24",125,72,53,
"195",2019,"25-29",179,83,96,
"195",2019,"30-34",210,102,108,
"195",2019,"35-39",212,98,114,
"195",2019,"40-44",187,90,97,
"195",2019,"45-49",214,108,106,
"195",2019,"50-54",187,106,81,
"195",2019,"55-59",225,119,106,
"195",2019,"60-64",268,133,135,
"195",2019,"65-69",241,143,98,
"195",2019,"70-74",185,88,97,
"195",2019,"75-79",112,65,47,
"195",2019,"80-84",47,23,24,
"195",2019,"85-89",28,13,15,
"195",2019,"90+",27,10,17,
"198",2019,"0-4",377,214,163,
"198",2019,"5-9",441,210,231,
"198",2019,"10-14",481,258,223,
"198",2019,"15-19",357,213,144,
"198",2019,"20-24",265,148,117,
"198",2019,"25-29",305,156,149,
"198",2019,"30-34",425,195,230,
"198",2019,"35-39",390,212,178,
"198",2019,"40-44",346,189,157,
"198",2019,"45-49",346,192,154,
"198",2019,"50-54",419,229,190,
"198",2019,"55-59",533,315,218,
"198",2019,"60-64",515,251,264,
"198",2019,"65-69",457,273,184,
"198",2019,"70-74",242,147,95,
"198",2019,"75-79",182,103,79,
"198",2019,"80-84",81,43,38,
"198",2019,"85-89",29,13,16,
"198",2019,"90+",12,9,3,
"220",2019,"0-4",437,251,186,
"220",2019,"5-9",470,257,213,
"220",2019,"10-14",581,325,256,
"220",2019,"15-19",500,245,255,
"220",2019,"20-24",425,229,196,
"220",2019,"25-29",600,282,318,
"220",2019,"30-34",638,291,347,
"220",2019,"35-39",610,325,285,
"220",2019,"40-44",578,306,272,
"220",2019,"45-49",499,258,241,
"220",2019,"50-54",507,250,257,
"220",2019,"55-59",632,329,303,
"220",2019,"60-64",660,335,325,
"220",2019,"65-69",495,236,259,
"220",2019,"70-74",347,172,175,
"220",2019,"75-79",236,110,126,
"220",2019,"80-84",194,77,117,
"220",2019,"85-89",77,27,50,
"220",2019,"90+",66,18,48,
"230",2019,"0-4",70,28,42,
"230",2019,"5-9",60,42,18,
"230",2019,"10-14",55,28,27,
"230",2019,"15-19",28,15,13,
"230",2019,"20-24",35,15,20,
"230",2019,"25-29",91,38,53,
"230",2019,"30-34",78,33,45,
"230",2019,"35-39",96,51,45,
"230",2019,"40-44",116,58,58,
"230",2019,"45-49",87,42,45,
"230",2019,"50-54",89,50,39,
"230",2019,"55-59",62,37,25,
"230",2019,"60-64",71,42,29,
"230",2019,"65-69",69,32,37,
"230",2019,"70-74",43,22,21,
"230",2019,"75-79",32,6,26,
"230",2019,"80-84",14,6,8,
"230",2019,"85-89",2,0,2,
"230",2019,"90+",1,0,1,
"240",2019,"0-4",422,206,216,
"240",2019,"5-9",494,254,240,
"240",2019,"10-14",503,265,238,
"240",2019,"15-19",432,244,188,
"240",2019,"20-24",288,148,140,
"240",2019,"25-29",450,257,193,
"240",2019,"30-34",516,263,253,
"240",2019,"35-39",467,269,198,
"240",2019,"40-44",421,240,181,
"240",2019,"45-49",415,243,172,
"240",2019,"50-54",437,231,206,
"240",2019,"55-59",495,282,213,
"240",2019,"60-64",483,266,217,
"240",2019,"65-69",412,264,148,
"240",2019,"70-74",304,163,141,
"240",2019,"75-79",167,91,76,
"240",2019,"80-84",106,61,45,
"240",2019,"85-89",52,14,38,
"240",2019,"90+",36,18,18,
"275",2019,"0-4",126,62,64,
"275",2019,"5-9",183,76,107,
"275",2019,"10-14",148,77,71,
"275",2019,"15-19",107,56,51,
"275",2019,"20-24",82,38,44,
"275",2019,"25-29",130,50,80,
"275",2019,"30-34",120,60,60,
"275",2019,"35-39",142,86,56,
"275",2019,"40-44",98,36,62,
"275",2019,"45-49",134,67,67,
"275",2019,"50-54",131,64,67,
"275",2019,"55-59",208,108,100,
"275",2019,"60-64",268,134,134,
"275",2019,"65-69",202,118,84,
"275",2019,"70-74",141,79,62,
"275",2019,"75-79",86,46,40,
"275",2019,"80-84",56,34,22,
"275",2019,"85-89",32,9,23,
"275",2019,"90+",12,5,7,
"282",2019,"0-4",36,19,17,
"282",2019,"5-9",32,15,17,
"282",2019,"10-14",29,11,18,
"282",2019,"15-19",30,13,17,
"282",2019,"20-24",21,12,9,
"282",2019,"25-29",32,18,14,
"282",2019,"30-34",30,12,18,
"282",2019,"35-39",41,26,15,
"282",2019,"40-44",28,18,10,
"282",2019,"45-49",35,22,13,
"282",2019,"50-54",48,32,16,
"282",2019,"55-59",30,18,12,
"282",2019,"60-64",43,27,16,
"282",2019,"65-69",46,24,22,
"282",2019,"70-74",29,16,13,
"282",2019,"75-79",8,6,2,
"282",2019,"80-84",20,6,14,
"282",2019,"85-89",3,0,3,
"282",2019,"90+",1,1,0,
"290",2019,"0-4",378,185,193,
"290",2019,"5-9",402,207,195,
"290",2019,"10-14",434,224,210,
"290",2019,"15-19",344,190,154,
"290",2019,"20-24",250,138,112,
"290",2019,"25-29",333,173,160,
"290",2019,"30-34",355,182,173,
"290",2019,"35-39",325,170,155,
"290",2019,"40-44",279,150,129,
"290",2019,"45-49",256,131,125,
"290",2019,"50-54",275,151,124,
"290",2019,"55-59",344,185,159,
"290",2019,"60-64",434,231,203,
"290",2019,"65-69",328,182,146,
"290",2019,"70-74",217,110,107,
"290",2019,"75-79",115,67,48,
"290",2019,"80-84",82,50,32,
"290",2019,"85-89",37,12,25,
"290",2019,"90+",21,11,10,
"000",2020,"0-4",48323,24847,23476,
"000",2020,"5-9",51987,26546,25441,
"000",2020,"10-14",52815,27280,25535,
"000",2020,"15-19",46684,24435,22249,
"000",2020,"20-24",45738,25065,20673,
"000",2020,"25-29",52868,27566,25302,
"000",2020,"30-34",57116,29073,28043,
"000",2020,"35-39",54715,28264,26451,
"000",2020,"40-44",44877,23111,21766,
"000",2020,"45-49",40978,20937,20041,
"000",2020,"50-54",42648,21907,20741,
"000",2020,"55-59",48055,24755,23300,
"000",2020,"60-64",46854,23882,22972,
"000",2020,"65-69",38405,19689,18716,
"000",2020,"70-74",26079,13355,12724,
"000",2020,"75-79",15430,7667,7763,
"000",2020,"80-84",8399,3951,4448,
"000",2020,"85-89",4442,1810,2632,
"000",2020,"90+",2490,877,1613,
"013",2020,"0-4",70,43,27,
"013",2020,"5-9",86,34,52,
"013",2020,"10-14",91,43,48,
"013",2020,"15-19",98,61,37,
"013",2020,"20-24",202,149,53,
"013",2020,"25-29",165,113,52,
"013",2020,"30-34",211,143,68,
"013",2020,"35-39",311,197,114,
"013",2020,"40-44",253,162,91,
"013",2020,"45-49",254,181,73,
"013",2020,"50-54",324,225,99,
"013",2020,"55-59",397,254,143,
"013",2020,"60-64",217,130,87,
"013",2020,"65-69",104,69,35,
"013",2020,"70-74",82,49,33,
"013",2020,"75-79",38,21,17,
"013",2020,"80-84",15,10,5,
"013",2020,"85-89",6,2,4,
"013",2020,"90+",1,1,0,
"016",2020,"0-4",214,112,102,
"016",2020,"5-9",249,110,139,
"016",2020,"10-14",238,141,97,
"016",2020,"15-19",232,143,89,
"016",2020,"20-24",274,173,101,
"016",2020,"25-29",480,360,120,
"016",2020,"30-34",492,321,171,
"016",2020,"35-39",510,334,176,
"016",2020,"40-44",473,335,138,
"016",2020,"45-49",394,259,135,
"016",2020,"50-54",605,364,241,
"016",2020,"55-59",517,347,170,
"016",2020,"60-64",427,299,128,
"016",2020,"65-69",293,213,80,
"016",2020,"70-74",106,67,39,
"016",2020,"75-79",21,11,10,
"016",2020,"80-84",10,5,5,
"016",2020,"85-89",6,2,4,
"016",2020,"90+",3,2,1,
"020",2020,"0-4",19146,9879,9267,
"020",2020,"5-9",19718,10015,9703,
"020",2020,"10-14",19791,10263,9528,
"020",2020,"15-19",18225,9378,8847,
"020",2020,"20-24",20410,10821,9589,
"020",2020,"25-29",22950,11820,11130,
"020",2020,"30-34",24138,12086,12052,
"020",2020,"35-39",22248,11195,11053,
"020",2020,"40-44",17902,8896,9006,
"020",2020,"45-49",16553,8084,8469,
"020",2020,"50-54",16791,8372,8419,
"020",2020,"55-59",18343,9078,9265,
"020",2020,"60-64",17300,8494,8806,
"020",2020,"65-69",14034,6997,7037,
"020",2020,"70-74",9511,4675,4836,
"020",2020,"75-79",5725,2650,3075,
"020",2020,"80-84",3302,1441,1861,
"020",2020,"85-89",1773,700,1073,
"020",2020,"90+",1110,359,751,
"050",2020,"0-4",1719,929,790,
"050",2020,"5-9",1790,931,859,
"050",2020,"10-14",1716,844,872,
"050",2020,"15-19",1565,829,736,
"050",2020,"20-24",1355,716,639,
"050",2020,"25-29",1473,730,743,
"050",2020,"30-34",1363,701,662,
"050",2020,"35-39",1023,523,500,
"050",2020,"40-44",883,445,438,
"050",2020,"45-49",830,429,401,
"050",2020,"50-54",852,487,365,
"050",2020,"55-59",997,531,466,
"050",2020,"60-64",838,450,388,
"050",2020,"65-69",655,366,289,
"050",2020,"70-74",356,184,172,
"050",2020,"75-79",261,128,133,
"050",2020,"80-84",115,57,58,
"050",2020,"85-89",63,16,47,
"050",2020,"90+",14,5,9,
"060",2020,"0-4",52,24,28,
"060",2020,"5-9",60,38,22,
"060",2020,"10-14",43,19,24,
"060",2020,"15-19",50,23,27,
"060",2020,"20-24",40,23,17,
"060",2020,"25-29",70,30,40,
"060",2020,"30-34",55,25,30,
"060",2020,"35-39",52,29,23,
"060",2020,"40-44",38,22,16,
"060",2020,"45-49",58,30,28,
"060",2020,"50-54",41,23,18,
"060",2020,"55-59",80,44,36,
"060",2020,"60-64",101,62,39,
"060",2020,"65-69",58,25,33,
"060",2020,"70-74",28,17,11,
"060",2020,"75-79",25,15,10,
"060",2020,"80-84",11,6,5,
"060",2020,"85-89",4,2,2,
"060",2020,"90+",2,1,1,
"063",2020,"0-4",452,230,222,
"063",2020,"5-9",501,264,237,
"063",2020,"10-14",452,233,219,
"063",2020,"15-19",378,218,160,
"063",2020,"20-24",291,161,130,
"063",2020,"25-29",501,280,221,
"063",2020,"30-34",562,304,258,
"063",2020,"35-39",517,271,246,
"063",2020,"40-44",440,230,210,
"063",2020,"45-49",381,201,180,
"063",2020,"50-54",426,231,195,
"063",2020,"55-59",497,274,223,
"063",2020,"60-64",521,269,252,
"063",2020,"65-69",396,202,194,
"063",2020,"70-74",215,108,107,
"063",2020,"75-79",125,71,54,
"063",2020,"80-84",54,22,32,
"063",2020,"85-89",31,14,17,
"063",2020,"90+",11,1,10,
"066",2020,"0-4",169,76,93,
"066",2020,"5-9",196,105,91,
"066",2020,"10-14",197,97,100,
"066",2020,"15-19",170,86,84,
"066",2020,"20-24",98,58,40,
"066",2020,"25-29",102,51,51,
"066",2020,"30-34",154,67,87,
"066",2020,"35-39",183,96,87,
"066",2020,"40-44",147,76,71,
"066",2020,"45-49",140,79,61,
"066",2020,"50-54",182,94,88,
"066",2020,"55-59",212,115,97,
"066",2020,"60-64",302,167,135,
"066",2020,"65-69",179,104,75,
"066",2020,"70-74",124,71,53,
"066",2020,"75-79",94,60,34,
"066",2020,"80-84",37,20,17,
"066",2020,"85-89",9,4,5,
"066",2020,"90+",4,2,2,
"068",2020,"0-4",87,40,47,
"068",2020,"5-9",110,58,52,
"068",2020,"10-14",111,59,52,
"068",2020,"15-19",79,34,45,
"068",2020,"20-24",42,20,22,
"068",2020,"25-29",110,57,53,
"068",2020,"30-34",145,64,81,
"068",2020,"35-39",150,78,72,
"068",2020,"40-44",134,66,68,
"068",2020,"45-49",134,68,66,
"068",2020,"50-54",123,74,49,
"068",2020,"55-59",158,86,72,
"068",2020,"60-64",167,111,56,
"068",2020,"65-69",119,71,48,
"068",2020,"70-74",49,32,17,
"068",2020,"75-79",41,23,18,
"068",2020,"80-84",38,17,21,
"068",2020,"85-89",7,6,1,
"068",2020,"90+",2,2,0,
"070",2020,"0-4",425,222,203,
"070",2020,"5-9",438,210,228,
"070",2020,"10-14",417,224,193,
"070",2020,"15-19",340,169,171,
"070",2020,"20-24",327,174,153,
"070",2020,"25-29",380,205,175,
"070",2020,"30-34",370,189,181,
"070",2020,"35-39",284,143,141,
"070",2020,"40-44",222,110,112,
"070",2020,"45-49",188,90,98,
"070",2020,"50-54",252,142,110,
"070",2020,"55-59",335,174,161,
"070",2020,"60-64",300,174,126,
"070",2020,"65-69",211,106,105,
"070",2020,"70-74",114,56,58,
"070",2020,"75-79",92,52,40,
"070",2020,"80-84",57,32,25,
"070",2020,"85-89",15,6,9,
"070",2020,"90+",6,3,3,
"090",2020,"0-4",6641,3365,3276,
"090",2020,"5-9",6809,3482,3327,
"090",2020,"10-14",6631,3412,3219,
"090",2020,"15-19",6104,3183,2921,
"090",2020,"20-24",7841,4608,3233,
"090",2020,"25-29",7698,4122,3576,
"090",2020,"30-34",7923,4060,3863,
"090",2020,"35-39",7496,3924,3572,
"090",2020,"40-44",5920,3103,2817,
"090",2020,"45-49",5176,2665,2511,
"090",2020,"50-54",5205,2636,2569,
"090",2020,"55-59",6030,3035,2995,
"090",2020,"60-64",5860,2997,2863,
"090",2020,"65-69",4823,2470,2353,
"090",2020,"70-74",3444,1795,1649,
"090",2020,"75-79",1844,959,885,
"090",2020,"80-84",953,464,489,
"090",2020,"85-89",494,196,298,
"090",2020,"90+",267,94,173,
"100",2020,"0-4",113,57,56,
"100",2020,"5-9",162,73,89,
"100",2020,"10-14",125,73,52,
"100",2020,"15-19",108,51,57,
"100",2020,"20-24",75,38,37,
"100",2020,"25-29",111,61,50,
"100",2020,"30-34",127,57,70,
"100",2020,"35-39",184,88,96,
"100",2020,"40-44",153,71,82,
"100",2020,"45-49",143,74,69,
"100",2020,"50-54",166,90,76,
"100",2020,"55-59",238,120,118,
"100",2020,"60-64",251,136,115,
"100",2020,"65-69",223,119,104,
"100",2020,"70-74",155,71,84,
"100",2020,"75-79",92,44,48,
"100",2020,"80-84",46,15,31,
"100",2020,"85-89",30,11,19,
"100",2020,"90+",18,5,13,
"105",2020,"0-4",99,47,52,
"105",2020,"5-9",117,61,56,
"105",2020,"10-14",134,68,66,
"105",2020,"15-19",103,43,60,
"105",2020,"20-24",69,30,39,
"105",2020,"25-29",99,61,38,
"105",2020,"30-34",116,62,54,
"105",2020,"35-39",120,59,61,
"105",2020,"40-44",105,49,56,
"105",2020,"45-49",104,53,51,
"105",2020,"50-54",129,76,53,
"105",2020,"55-59",157,72,85,
"105",2020,"60-64",206,108,98,
"105",2020,"65-69",212,113,99,
"105",2020,"70-74",139,82,57,
"105",2020,"75-79",87,57,30,
"105",2020,"80-84",58,43,15,
"105",2020,"85-89",13,5,8,
"105",2020,"90+",7,5,2,
"110",2020,"0-4",1707,853,854,
"110",2020,"5-9",1952,1000,952,
"110",2020,"10-14",2051,1013,1038,
"110",2020,"15-19",1882,968,914,
"110",2020,"20-24",1548,816,732,
"110",2020,"25-29",2262,1202,1060,
"110",2020,"30-34",2561,1279,1282,
"110",2020,"35-39",2545,1267,1278,
"110",2020,"40-44",2111,1072,1039,
"110",2020,"45-49",1915,1009,906,
"110",2020,"50-54",2101,1033,1068,
"110",2020,"55-59",2350,1204,1146,
"110",2020,"60-64",2215,1143,1072,
"110",2020,"65-69",1858,869,989,
"110",2020,"70-74",1333,718,615,
"110",2020,"75-79",681,297,384,
"110",2020,"80-84",418,194,224,
"110",2020,"85-89",179,80,99,
"110",2020,"90+",104,34,70,
"122",2020,"0-4",3466,1744,1722,
"122",2020,"5-9",3693,1903,1790,
"122",2020,"10-14",3956,1997,1959,
"122",2020,"15-19",3418,1803,1615,
"122",2020,"20-24",2483,1402,1081,
"122",2020,"25-29",3353,1788,1565,
"122",2020,"30-34",3744,1903,1841,
"122",2020,"35-39",4108,2184,1924,
"122",2020,"40-44",3506,1890,1616,
"122",2020,"45-49",3296,1690,1606,
"122",2020,"50-54",3539,1836,1703,
"122",2020,"55-59",4262,2127,2135,
"122",2020,"60-64",4793,2445,2348,
"122",2020,"65-69",4335,2287,2048,
"122",2020,"70-74",3172,1669,1503,
"122",2020,"75-79",2043,1094,949,
"122",2020,"80-84",938,481,457,
"122",2020,"85-89",536,246,290,
"122",2020,"90+",293,97,196,
"130",2020,"0-4",685,354,331,
"130",2020,"5-9",844,447,397,
"130",2020,"10-14",894,450,444,
"130",2020,"15-19",861,455,406,
"130",2020,"20-24",762,426,336,
"130",2020,"25-29",848,456,392,
"130",2020,"30-34",938,434,504,
"130",2020,"35-39",1011,505,506,
"130",2020,"40-44",862,441,421,
"130",2020,"45-49",792,384,408,
"130",2020,"50-54",868,417,451,
"130",2020,"55-59",998,539,459,
"130",2020,"60-64",1009,500,509,
"130",2020,"65-69",852,413,439,
"130",2020,"70-74",638,307,331,
"130",2020,"75-79",422,228,194,
"130",2020,"80-84",218,113,105,
"130",2020,"85-89",102,37,65,
"130",2020,"90+",73,36,37,
"150",2020,"0-4",805,420,385,
"150",2020,"5-9",930,499,431,
"150",2020,"10-14",971,500,471,
"150",2020,"15-19",788,426,362,
"150",2020,"20-24",791,448,343,
"150",2020,"25-29",891,458,433,
"150",2020,"30-34",998,562,436,
"150",2020,"35-39",935,494,441,
"150",2020,"40-44",762,367,395,
"150",2020,"45-49",691,341,350,
"150",2020,"50-54",743,369,374,
"150",2020,"55-59",855,455,400,
"150",2020,"60-64",842,490,352,
"150",2020,"65-69",663,304,359,
"150",2020,"70-74",452,225,227,
"150",2020,"75-79",253,131,122,
"150",2020,"80-84",126,52,74,
"150",2020,"85-89",77,26,51,
"150",2020,"90+",38,13,25,
"158",2020,"0-4",860,475,385,
"158",2020,"5-9",865,446,419,
"158",2020,"10-14",940,513,427,
"158",2020,"15-19",793,390,403,
"158",2020,"20-24",688,386,302,
"158",2020,"25-29",649,328,321,
"158",2020,"30-34",621,344,277,
"158",2020,"35-39",421,223,198,
"158",2020,"40-44",325,161,164,
"158",2020,"45-49",316,154,162,
"158",2020,"50-54",360,180,180,
"158",2020,"55-59",383,204,179,
"158",2020,"60-64",338,183,155,
"158",2020,"65-69",217,122,95,
"158",2020,"70-74",154,76,78,
"158",2020,"75-79",74,33,41,
"158",2020,"80-84",37,17,20,
"158",2020,"85-89",40,11,29,
"158",2020,"90+",7,2,5,
"164",2020,"0-4",138,69,69,
"164",2020,"5-9",121,61,60,
"164",2020,"10-14",124,62,62,
"164",2020,"15-19",108,50,58,
"164",2020,"20-24",80,34,46,
"164",2020,"25-29",110,53,57,
"164",2020,"30-34",119,70,49,
"164",2020,"35-39",124,51,73,
"164",2020,"40-44",93,58,35,
"164",2020,"45-49",60,30,30,
"164",2020,"50-54",81,40,41,
"164",2020,"55-59",115,70,45,
"164",2020,"60-64",113,58,55,
"164",2020,"65-69",76,42,34,
"164",2020,"70-74",42,26,16,
"164",2020,"75-79",21,12,9,
"164",2020,"80-84",18,11,7,
"164",2020,"85-89",8,3,5,
"164",2020,"90+",1,0,1,
"170",2020,"0-4",7371,3824,3547,
"170",2020,"5-9",8588,4376,4212,
"170",2020,"10-14",8967,4664,4303,
"170",2020,"15-19",7459,3983,3476,
"170",2020,"20-24",5155,2798,2357,
"170",2020,"25-29",6547,3288,3259,
"170",2020,"30-34",7578,3798,3780,
"170",2020,"35-39",8148,4148,4000,
"170",2020,"40-44",6903,3571,3332,
"170",2020,"45-49",6267,3268,2999,
"170",2020,"50-54",6262,3158,3104,
"170",2020,"55-59",6962,3657,3305,
"170",2020,"60-64",6944,3455,3489,
"170",2020,"65-69",5843,2965,2878,
"170",2020,"70-74",3899,1991,1908,
"170",2020,"75-79",2243,1158,1085,
"170",2020,"80-84",1193,576,617,
"170",2020,"85-89",665,314,351,
"170",2020,"90+",311,127,184,
"180",2020,"0-4",796,390,406,
"180",2020,"5-9",931,471,460,
"180",2020,"10-14",966,527,439,
"180",2020,"15-19",808,426,382,
"180",2020,"20-24",672,379,293,
"180",2020,"25-29",816,424,392,
"180",2020,"30-34",786,396,390,
"180",2020,"35-39",651,342,309,
"180",2020,"40-44",585,341,244,
"180",2020,"45-49",468,244,224,
"180",2020,"50-54",452,260,192,
"180",2020,"55-59",532,270,262,
"180",2020,"60-64",504,245,259,
"180",2020,"65-69",369,204,165,
"180",2020,"70-74",206,130,76,
"180",2020,"75-79",115,47,68,
"180",2020,"80-84",70,39,31,
"180",2020,"85-89",27,16,11,
"180",2020,"90+",15,3,12,
"185",2020,"0-4",639,310,329,
"185",2020,"5-9",760,392,368,
"185",2020,"10-14",779,391,388,
"185",2020,"15-19",605,332,273,
"185",2020,"20-24",581,339,242,
"185",2020,"25-29",791,478,313,
"185",2020,"30-34",992,631,361,
"185",2020,"35-39",914,622,292,
"185",2020,"40-44",558,342,216,
"185",2020,"45-49",561,380,181,
"185",2020,"50-54",658,464,194,
"185",2020,"55-59",754,524,230,
"185",2020,"60-64",633,409,224,
"185",2020,"65-69",314,190,124,
"185",2020,"70-74",123,70,53,
"185",2020,"75-79",47,26,21,
"185",2020,"80-84",40,14,26,
"185",2020,"85-89",14,2,12,
"185",2020,"90+",8,6,2,
"188",2020,"0-4",691,358,333,
"188",2020,"5-9",755,408,347,
"188",2020,"10-14",797,400,397,
"188",2020,"15-19",613,341,272,
"188",2020,"20-24",510,272,238,
"188",2020,"25-29",538,266,272,
"188",2020,"30-34",665,378,287,
"188",2020,"35-39",488,264,224,
"188",2020,"40-44",383,187,196,
"188",2020,"45-49",353,199,154,
"188",2020,"50-54",394,243,151,
"188",2020,"55-59",432,239,193,
"188",2020,"60-64",362,204,158,
"188",2020,"65-69",239,143,96,
"188",2020,"70-74",158,80,78,
"188",2020,"75-79",89,48,41,
"188",2020,"80-84",58,29,29,
"188",2020,"85-89",45,10,35,
"188",2020,"90+",13,3,10,
"195",2020,"0-4",177,88,89,
"195",2020,"5-9",218,90,128,
"195",2020,"10-14",224,118,106,
"195",2020,"15-19",146,75,71,
"195",2020,"20-24",117,66,51,
"195",2020,"25-29",176,82,94,
"195",2020,"30-34",212,110,102,
"195",2020,"35-39",213,100,113,
"195",2020,"40-44",184,82,102,
"195",2020,"45-49",198,98,100,
"195",2020,"50-54",192,112,80,
"195",2020,"55-59",215,112,103,
"195",2020,"60-64",244,118,126,
"195",2020,"65-69",248,146,102,
"195",2020,"70-74",193,88,105,
"195",2020,"75-79",128,72,56,
"195",2020,"80-84",51,21,30,
"195",2020,"85-89",26,14,12,
"195",2020,"90+",27,9,18,
"198",2020,"0-4",353,195,158,
"198",2020,"5-9",431,229,202,
"198",2020,"10-14",457,231,226,
"198",2020,"15-19",345,204,141,
"198",2020,"20-24",256,142,114,
"198",2020,"25-29",264,134,130,
"198",2020,"30-34",441,208,233,
"198",2020,"35-39",380,204,176,
"198",2020,"40-44",341,195,146,
"198",2020,"45-49",334,191,143,
"198",2020,"50-54",430,232,198,
"198",2020,"55-59",528,311,217,
"198",2020,"60-64",497,252,245,
"198",2020,"65-69",476,276,200,
"198",2020,"70-74",260,159,101,
"198",2020,"75-79",178,97,81,
"198",2020,"80-84",79,41,38,
"198",2020,"85-89",31,17,14,
"198",2020,"90+",9,5,4,
"220",2020,"0-4",459,240,219,
"220",2020,"5-9",477,258,219,
"220",2020,"10-14",537,298,239,
"220",2020,"15-19",485,241,244,
"220",2020,"20-24",439,245,194,
"220",2020,"25-29",560,256,304,
"220",2020,"30-34",629,283,346,
"220",2020,"35-39",624,316,308,
"220",2020,"40-44",605,319,286,
"220",2020,"45-49",489,236,253,
"220",2020,"50-54",504,253,251,
"220",2020,"55-59",598,304,294,
"220",2020,"60-64",639,325,314,
"220",2020,"65-69",529,251,278,
"220",2020,"70-74",359,186,173,
"220",2020,"75-79",254,117,137,
"220",2020,"80-84",183,73,110,
"220",2020,"85-89",86,26,60,
"220",2020,"90+",67,19,48,
"230",2020,"0-4",62,25,37,
"230",2020,"5-9",66,39,27,
"230",2020,"10-14",64,40,24,
"230",2020,"15-19",29,14,15,
"230",2020,"20-24",31,14,17,
"230",2020,"25-29",77,31,46,
"230",2020,"30-34",99,43,56,
"230",2020,"35-39",96,56,40,
"230",2020,"40-44",129,58,71,
"230",2020,"45-49",94,51,43,
"230",2020,"50-54",91,47,44,
"230",2020,"55-59",63,39,24,
"230",2020,"60-64",70,38,32,
"230",2020,"65-69",74,37,37,
"230",2020,"70-74",43,22,21,
"230",2020,"75-79",39,6,33,
"230",2020,"80-84",16,9,7,
"230",2020,"85-89",3,1,2,
"230",2020,"90+",1,0,1,
"240",2020,"0-4",404,200,204,
"240",2020,"5-9",529,264,265,
"240",2020,"10-14",519,284,235,
"240",2020,"15-19",427,242,185,
"240",2020,"20-24",283,153,130,
"240",2020,"25-29",387,211,176,
"240",2020,"30-34",578,312,266,
"240",2020,"35-39",483,279,204,
"240",2020,"40-44",423,231,192,
"240",2020,"45-49",391,234,157,
"240",2020,"50-54",434,228,206,
"240",2020,"55-59",476,269,207,
"240",2020,"60-64",474,263,211,
"240",2020,"65-69",429,261,168,
"240",2020,"70-74",317,175,142,
"240",2020,"75-79",170,87,83,
"240",2020,"80-84",102,57,45,
"240",2020,"85-89",74,19,55,
"240",2020,"90+",37,20,17,
"275",2020,"0-4",124,63,61,
"275",2020,"5-9",166,66,100,
"275",2020,"10-14",158,77,81,
"275",2020,"15-19",120,66,54,
"275",2020,"20-24",61,35,26,
"275",2020,"25-29",125,51,74,
"275",2020,"30-34",130,59,71,
"275",2020,"35-39",148,88,60,
"275",2020,"40-44",101,40,61,
"275",2020,"45-49",128,73,55,
"275",2020,"50-54",127,54,73,
"275",2020,"55-59",198,102,96,
"275",2020,"60-64",245,125,120,
"275",2020,"65-69",199,102,97,
"275",2020,"70-74",146,89,57,
"275",2020,"75-79",94,50,44,
"275",2020,"80-84",58,35,23,
"275",2020,"85-89",35,9,26,
"275",2020,"90+",16,9,7,
"282",2020,"0-4",35,22,13,
"282",2020,"5-9",42,19,23,
"282",2020,"10-14",27,7,20,
"282",2020,"15-19",37,20,17,
"282",2020,"20-24",20,10,10,
"282",2020,"25-29",31,18,13,
"282",2020,"30-34",34,12,22,
"282",2020,"35-39",43,28,15,
"282",2020,"40-44",39,25,14,
"282",2020,"45-49",32,22,10,
"282",2020,"50-54",49,32,17,
"282",2020,"55-59",34,20,14,
"282",2020,"60-64",41,20,21,
"282",2020,"65-69",45,25,20,
"282",2020,"70-74",30,17,13,
"282",2020,"75-79",8,5,3,
"282",2020,"80-84",20,11,9,
"282",2020,"85-89",5,0,5,
"282",2020,"90+",2,2,0,
"290",2020,"0-4",364,193,171,
"290",2020,"5-9",383,197,186,
"290",2020,"10-14",438,232,206,
"290",2020,"15-19",308,181,127,
"290",2020,"20-24",237,129,108,
"290",2020,"25-29",304,152,152,
"290",2020,"30-34",335,172,163,
"290",2020,"35-39",305,156,149,
"290",2020,"40-44",297,166,131,
"290",2020,"45-49",238,120,118,
"290",2020,"50-54",267,135,132,
"290",2020,"55-59",339,179,160,
"290",2020,"60-64",401,212,189,
"290",2020,"65-69",332,197,135,
"290",2020,"70-74",231,120,111,
"290",2020,"75-79",126,68,58,
"290",2020,"80-84",78,46,32,
"290",2020,"85-89",38,15,23,
"290",2020,"90+",23,12,11,
