"Borough/Census Area FIPS","Year","Age","Total","Male","Female","Data from: https://web.archive.org/web/20210611231927/https://live.laborstats.alaska.gov/pop/estimates/data/AgeBySexBCA_1990to2000.xls via https://web.archive.org/web/20210611231927/https://live.laborstats.alaska.gov/pop/index.cfm March 2023 "
"000","1990","0-4",55977,28725,27252,
"000","1990","5-9",51508,26543,24965,
"000","1990","10-14",42939,22333,20606,
"000","1990","15-19",37428,19950,17478,
"000","1990","20-24",41657,23014,18643,
"000","1990","25-29",53775,28404,25371,
"000","1990","30-34",59741,30777,28964,
"000","1990","35-39",57171,30425,26746,
"000","1990","40-44",45277,24603,20674,
"000","1990","45-49",31531,17242,14289,
"000","1990","50-54",21713,11852,9861,
"000","1990","55-59",16418,8769,7649,
"000","1990","60-64",12813,6813,6000,
"000","1990","65-69",9499,4704,4795,
"000","1990","70-74",5892,2818,3074,
"000","1990","75-79",3590,1682,1908,
"000","1990","80-84",1914,758,1156,
"000","1990","85+",1200,456,744,
"013","1990","0-4",185,93,92,
"013","1990","5-9",186,103,83,
"013","1990","10-14",120,59,61,
"013","1990","15-19",145,99,46,
"013","1990","20-24",328,239,89,
"013","1990","25-29",350,239,111,
"013","1990","30-34",294,195,99,
"013","1990","35-39",251,164,87,
"013","1990","40-44",180,121,59,
"013","1990","45-49",129,78,51,
"013","1990","50-54",111,67,44,
"013","1990","55-59",83,60,23,
"013","1990","60-64",49,33,16,
"013","1990","65-69",33,22,11,
"013","1990","70-74",14,8,6,
"013","1990","75-79",4,0,4,
"013","1990","80-84",1,0,1,
"013","1990","85+",1,1,0,
"016","1990","0-4",800,428,372,
"016","1990","5-9",550,288,262,
"016","1990","10-14",384,195,189,
"016","1990","15-19",624,433,191,
"016","1990","20-24",1757,1243,514,
"016","1990","25-29",1636,1123,513,
"016","1990","30-34",1280,863,417,
"016","1990","35-39",950,652,298,
"016","1990","40-44",631,448,183,
"016","1990","45-49",327,225,102,
"016","1990","50-54",232,157,75,
"016","1990","55-59",137,83,54,
"016","1990","60-64",88,60,28,
"016","1990","65-69",40,23,17,
"016","1990","70-74",16,8,8,
"016","1990","75-79",16,8,8,
"016","1990","80-84",7,3,4,
"016","1990","85+",3,3,0,
"020","1990","0-4",21989,11277,10712,
"020","1990","5-9",19677,10109,9568,
"020","1990","10-14",16288,8419,7869,
"020","1990","15-19",15405,8131,7274,
"020","1990","20-24",17999,9614,8385,
"020","1990","25-29",23546,12006,11540,
"020","1990","30-34",25240,12669,12571,
"020","1990","35-39",23916,12371,11545,
"020","1990","40-44",19181,9984,9197,
"020","1990","45-49",13575,7174,6401,
"020","1990","50-54",9351,4867,4484,
"020","1990","55-59",6910,3564,3346,
"020","1990","60-64",5108,2609,2499,
"020","1990","65-69",3778,1747,2031,
"020","1990","70-74",2146,990,1156,
"020","1990","75-79",1219,515,704,
"020","1990","80-84",651,221,430,
"020","1990","85+",359,98,261,
"050","1990","0-4",1853,959,894,
"050","1990","5-9",1546,767,779,
"050","1990","10-14",1251,656,595,
"050","1990","15-19",1080,523,557,
"050","1990","20-24",1102,564,538,
"050","1990","25-29",1343,731,612,
"050","1990","30-34",1204,631,573,
"050","1990","35-39",1052,591,461,
"050","1990","40-44",781,455,326,
"050","1990","45-49",699,372,327,
"050","1990","50-54",411,201,210,
"050","1990","55-59",396,210,186,
"050","1990","60-64",303,171,132,
"050","1990","65-69",226,118,108,
"050","1990","70-74",185,82,103,
"050","1990","75-79",128,65,63,
"050","1990","80-84",51,31,20,
"050","1990","85+",45,27,18,
"060","1990","0-4",121,55,66,
"060","1990","5-9",108,58,50,
"060","1990","10-14",100,47,53,
"060","1990","15-19",76,43,33,
"060","1990","20-24",121,79,42,
"060","1990","25-29",203,141,62,
"060","1990","30-34",198,131,67,
"060","1990","35-39",162,98,64,
"060","1990","40-44",90,52,38,
"060","1990","45-49",70,46,24,
"060","1990","50-54",57,29,28,
"060","1990","55-59",41,31,10,
"060","1990","60-64",26,16,10,
"060","1990","65-69",14,6,8,
"060","1990","70-74",12,6,6,
"060","1990","75-79",6,3,3,
"060","1990","80-84",3,0,3,
"060","1990","85+",2,1,1,
"068","1990","0-4",144,70,74,
"068","1990","5-9",149,77,72,
"068","1990","10-14",141,73,68,
"068","1990","15-19",92,50,42,
"068","1990","20-24",85,52,33,
"068","1990","25-29",145,83,62,
"068","1990","30-34",198,107,91,
"068","1990","35-39",218,113,105,
"068","1990","40-44",180,109,71,
"068","1990","45-49",158,106,52,
"068","1990","50-54",116,79,37,
"068","1990","55-59",71,46,25,
"068","1990","60-64",28,20,8,
"068","1990","65-69",20,13,7,
"068","1990","70-74",12,7,5,
"068","1990","75-79",4,2,2,
"068","1990","80-84",3,2,1,
"068","1990","85+",0,0,0,
"070","1990","0-4",564,286,278,
"070","1990","5-9",454,238,216,
"070","1990","10-14",329,168,161,
"070","1990","15-19",253,138,115,
"070","1990","20-24",258,125,133,
"070","1990","25-29",363,191,172,
"070","1990","30-34",408,212,196,
"070","1990","35-39",393,201,192,
"070","1990","40-44",224,131,93,
"070","1990","45-49",205,103,102,
"070","1990","50-54",136,69,67,
"070","1990","55-59",126,71,55,
"070","1990","60-64",98,49,49,
"070","1990","65-69",80,36,44,
"070","1990","70-74",42,18,24,
"070","1990","75-79",36,19,17,
"070","1990","80-84",27,13,14,
"070","1990","85+",16,8,8,
"090","1990","0-4",8290,4269,4021,
"090","1990","5-9",7362,3818,3544,
"090","1990","10-14",5886,3104,2782,
"090","1990","15-19",5363,2918,2445,
"090","1990","20-24",7762,4548,3214,
"090","1990","25-29",8464,4489,3975,
"090","1990","30-34",8533,4347,4186,
"090","1990","35-39",7741,4190,3551,
"090","1990","40-44",5987,3299,2688,
"090","1990","45-49",3878,2104,1774,
"090","1990","50-54",2524,1404,1120,
"090","1990","55-59",1931,1009,922,
"090","1990","60-64",1494,808,686,
"090","1990","65-69",1083,531,552,
"090","1990","70-74",681,328,353,
"090","1990","75-79",400,204,196,
"090","1990","80-84",204,79,125,
"090","1990","85+",137,52,85,
"100","1990","0-4",161,85,76,
"100","1990","5-9",174,88,86,
"100","1990","10-14",161,82,79,
"100","1990","15-19",137,78,59,
"100","1990","20-24",100,54,46,
"100","1990","25-29",144,70,74,
"100","1990","30-34",214,122,92,
"100","1990","35-39",219,117,102,
"100","1990","40-44",207,115,92,
"100","1990","45-49",152,81,71,
"100","1990","50-54",107,52,55,
"100","1990","55-59",91,53,38,
"100","1990","60-64",70,40,30,
"100","1990","65-69",70,39,31,
"100","1990","70-74",60,27,33,
"100","1990","75-79",36,20,16,
"100","1990","80-84",10,1,9,
"100","1990","85+",4,2,2,
"110","1990","0-4",2470,1265,1205,
"110","1990","5-9",2371,1227,1144,
"110","1990","10-14",2014,1055,959,
"110","1990","15-19",1638,833,805,
"110","1990","20-24",1556,762,794,
"110","1990","25-29",2329,1174,1155,
"110","1990","30-34",2886,1427,1459,
"110","1990","35-39",3083,1537,1546,
"110","1990","40-44",2654,1382,1272,
"110","1990","45-49",1747,928,819,
"110","1990","50-54",1195,658,537,
"110","1990","55-59",804,429,375,
"110","1990","60-64",649,316,333,
"110","1990","65-69",487,221,266,
"110","1990","70-74",396,160,236,
"110","1990","75-79",235,112,123,
"110","1990","80-84",144,55,89,
"110","1990","85+",93,38,55,
"122","1990","0-4",3862,1955,1907,
"122","1990","5-9",4059,2088,1971,
"122","1990","10-14",3516,1876,1640,
"122","1990","15-19",2970,1581,1389,
"122","1990","20-24",2081,1106,975,
"122","1990","25-29",3097,1640,1457,
"122","1990","30-34",4251,2163,2088,
"122","1990","35-39",4569,2451,2118,
"122","1990","40-44",3665,2034,1631,
"122","1990","45-49",2504,1414,1090,
"122","1990","50-54",1701,926,775,
"122","1990","55-59",1376,751,625,
"122","1990","60-64",1164,619,545,
"122","1990","65-69",900,475,425,
"122","1990","70-74",589,296,293,
"122","1990","75-79",260,140,120,
"122","1990","80-84",159,73,86,
"122","1990","85+",79,25,54,
"130","1990","0-4",1240,656,584,
"130","1990","5-9",1214,603,611,
"130","1990","10-14",1106,595,511,
"130","1990","15-19",927,483,444,
"130","1990","20-24",860,463,397,
"130","1990","25-29",1163,594,569,
"130","1990","30-34",1392,715,677,
"130","1990","35-39",1350,698,652,
"130","1990","40-44",1191,637,554,
"130","1990","45-49",935,499,436,
"130","1990","50-54",657,377,280,
"130","1990","55-59",465,258,207,
"130","1990","60-64",420,227,193,
"130","1990","65-69",327,168,159,
"130","1990","70-74",251,111,140,
"130","1990","75-79",160,80,80,
"130","1990","80-84",90,36,54,
"130","1990","85+",80,32,48,
"150","1990","0-4",1442,757,685,
"150","1990","5-9",1197,626,571,
"150","1990","10-14",1022,509,513,
"150","1990","15-19",839,465,374,
"150","1990","20-24",1112,678,434,
"150","1990","25-29",1466,832,634,
"150","1990","30-34",1556,890,666,
"150","1990","35-39",1474,831,643,
"150","1990","40-44",1073,619,454,
"150","1990","45-49",687,390,297,
"150","1990","50-54",428,246,182,
"150","1990","55-59",331,191,140,
"150","1990","60-64",252,147,105,
"150","1990","65-69",172,91,81,
"150","1990","70-74",122,69,53,
"150","1990","75-79",71,23,48,
"150","1990","80-84",37,17,20,
"150","1990","85+",28,7,21,
"164","1990","0-4",216,106,110,
"164","1990","5-9",200,97,103,
"164","1990","10-14",159,84,75,
"164","1990","15-19",93,53,40,
"164","1990","20-24",99,52,47,
"164","1990","25-29",162,92,70,
"164","1990","30-34",186,108,78,
"164","1990","35-39",136,73,63,
"164","1990","40-44",90,56,34,
"164","1990","45-49",78,46,32,
"164","1990","50-54",58,33,25,
"164","1990","55-59",53,34,19,
"164","1990","60-64",51,30,21,
"164","1990","65-69",39,22,17,
"164","1990","70-74",22,12,10,
"164","1990","75-79",15,7,8,
"164","1990","80-84",9,5,4,
"164","1990","85+",2,1,1,
"170","1990","0-4",3949,2024,1925,
"170","1990","5-9",4382,2268,2114,
"170","1990","10-14",3882,1976,1906,
"170","1990","15-19",2646,1376,1270,
"170","1990","20-24",1597,787,810,
"170","1990","25-29",2776,1351,1425,
"170","1990","30-34",4367,2148,2219,
"170","1990","35-39",4623,2419,2204,
"170","1990","40-44",3471,1894,1577,
"170","1990","45-49",2302,1315,987,
"170","1990","50-54",1543,874,669,
"170","1990","55-59",1231,656,575,
"170","1990","60-64",1071,596,475,
"170","1990","65-69",807,416,391,
"170","1990","70-74",494,264,230,
"170","1990","75-79",291,139,152,
"170","1990","80-84",153,73,80,
"170","1990","85+",98,42,56,
"180","1990","0-4",1093,558,535,
"180","1990","5-9",904,437,467,
"180","1990","10-14",760,406,354,
"180","1990","15-19",636,345,291,
"180","1990","20-24",570,313,257,
"180","1990","25-29",734,418,316,
"180","1990","30-34",791,423,368,
"180","1990","35-39",678,389,289,
"180","1990","40-44",575,355,220,
"180","1990","45-49",393,219,174,
"180","1990","50-54",293,168,125,
"180","1990","55-59",248,142,106,
"180","1990","60-64",198,99,99,
"180","1990","65-69",143,80,63,
"180","1990","70-74",97,51,46,
"180","1990","75-79",105,45,60,
"180","1990","80-84",45,15,30,
"180","1990","85+",25,13,12,
"185","1990","0-4",840,440,400,
"185","1990","5-9",694,353,341,
"185","1990","10-14",491,255,236,
"185","1990","15-19",373,178,195,
"185","1990","20-24",426,228,198,
"185","1990","25-29",588,306,282,
"185","1990","30-34",586,332,254,
"185","1990","35-39",516,307,209,
"185","1990","40-44",396,243,153,
"185","1990","45-49",316,187,129,
"185","1990","50-54",247,150,97,
"185","1990","55-59",193,117,76,
"185","1990","60-64",123,72,51,
"185","1990","65-69",77,39,38,
"185","1990","70-74",45,21,24,
"185","1990","75-79",41,14,27,
"185","1990","80-84",20,10,10,
"185","1990","85+",7,3,4,
"188","1990","0-4",983,497,486,
"188","1990","5-9",765,398,367,
"188","1990","10-14",579,294,285,
"188","1990","15-19",486,266,220,
"188","1990","20-24",465,243,222,
"188","1990","25-29",571,317,254,
"188","1990","30-34",523,274,249,
"188","1990","35-39",406,235,171,
"188","1990","40-44",331,183,148,
"188","1990","45-49",224,121,103,
"188","1990","50-54",178,110,68,
"188","1990","55-59",172,80,92,
"188","1990","60-64",157,88,69,
"188","1990","65-69",91,39,52,
"188","1990","70-74",62,34,28,
"188","1990","75-79",57,26,31,
"188","1990","80-84",31,10,21,
"188","1990","85+",32,14,18,
"201","1990","0-4",616,318,298,
"201","1990","5-9",617,306,311,
"201","1990","10-14",556,301,255,
"201","1990","15-19",393,219,174,
"201","1990","20-24",389,213,176,
"201","1990","25-29",540,305,235,
"201","1990","30-34",671,380,291,
"201","1990","35-39",658,389,269,
"201","1990","40-44",543,313,230,
"201","1990","45-49",440,276,164,
"201","1990","50-54",287,189,98,
"201","1990","55-59",205,124,81,
"201","1990","60-64",150,94,56,
"201","1990","65-69",101,57,44,
"201","1990","70-74",43,26,17,
"201","1990","75-79",27,15,12,
"201","1990","80-84",28,12,16,
"201","1990","85+",14,8,6,
"220","1990","0-4",764,360,404,
"220","1990","5-9",807,444,363,
"220","1990","10-14",730,390,340,
"220","1990","15-19",550,297,253,
"220","1990","20-24",588,335,253,
"220","1990","25-29",791,430,361,
"220","1990","30-34",889,434,455,
"220","1990","35-39",860,437,423,
"220","1990","40-44",665,375,290,
"220","1990","45-49",522,293,229,
"220","1990","50-54",423,229,194,
"220","1990","55-59",278,149,129,
"220","1990","60-64",239,125,114,
"220","1990","65-69",182,84,98,
"220","1990","70-74",107,51,56,
"220","1990","75-79",81,39,42,
"220","1990","80-84",61,25,36,
"220","1990","85+",51,12,39,
"232","1990","0-4",338,168,170,
"232","1990","5-9",378,209,169,
"232","1990","10-14",336,156,180,
"232","1990","15-19",244,135,109,
"232","1990","20-24",167,91,76,
"232","1990","25-29",281,157,124,
"232","1990","30-34",406,239,167,
"232","1990","35-39",404,232,172,
"232","1990","40-44",312,190,122,
"232","1990","45-49",225,115,110,
"232","1990","50-54",167,102,65,
"232","1990","55-59",128,84,44,
"232","1990","60-64",99,53,46,
"232","1990","65-69",86,48,38,
"232","1990","70-74",47,17,30,
"232","1990","75-79",35,18,17,
"232","1990","80-84",17,5,12,
"232","1990","85+",10,7,3,
"240","1990","0-4",603,300,303,
"240","1990","5-9",672,362,310,
"240","1990","10-14",575,329,246,
"240","1990","15-19",412,230,182,
"240","1990","20-24",362,189,173,
"240","1990","25-29",463,251,212,
"240","1990","30-34",640,315,325,
"240","1990","35-39",586,317,269,
"240","1990","40-44",502,272,230,
"240","1990","45-49",337,192,145,
"240","1990","50-54",256,152,104,
"240","1990","55-59",153,80,73,
"240","1990","60-64",132,79,53,
"240","1990","65-69",97,58,39,
"240","1990","70-74",55,28,27,
"240","1990","75-79",36,15,21,
"240","1990","80-84",13,6,7,
"240","1990","85+",19,10,9,
"261","1990","0-4",887,464,423,
"261","1990","5-9",860,440,420,
"261","1990","10-14",783,423,360,
"261","1990","15-19",639,339,300,
"261","1990","20-24",555,311,244,
"261","1990","25-29",842,477,365,
"261","1990","30-34",1116,605,511,
"261","1990","35-39",1155,619,536,
"261","1990","40-44",930,527,403,
"261","1990","45-49",635,370,265,
"261","1990","50-54",472,271,201,
"261","1990","55-59",336,203,133,
"261","1990","60-64",286,168,118,
"261","1990","65-69",194,107,87,
"261","1990","70-74",114,56,58,
"261","1990","75-79",89,54,35,
"261","1990","80-84",34,14,20,
"261","1990","85+",25,15,10,
"270","1990","0-4",1037,542,495,
"270","1990","5-9",719,354,365,
"270","1990","10-14",564,270,294,
"270","1990","15-19",483,242,241,
"270","1990","20-24",499,247,252,
"270","1990","25-29",504,271,233,
"270","1990","30-34",433,247,186,
"270","1990","35-39",331,179,152,
"270","1990","40-44",284,153,131,
"270","1990","45-49",195,112,83,
"270","1990","50-54",180,99,81,
"270","1990","55-59",175,85,90,
"270","1990","60-64",125,64,61,
"270","1990","65-69",122,67,55,
"270","1990","70-74",56,32,24,
"270","1990","75-79",48,24,24,
"270","1990","80-84",24,12,12,
"270","1990","85+",12,9,3,
"280","1990","0-4",688,361,327,
"280","1990","5-9",649,351,298,
"280","1990","10-14",546,259,287,
"280","1990","15-19",446,236,210,
"280","1990","20-24",381,220,161,
"280","1990","25-29",576,301,275,
"280","1990","30-34",745,386,359,
"280","1990","35-39",726,410,316,
"280","1990","40-44",589,324,265,
"280","1990","45-49",429,247,182,
"280","1990","50-54",300,180,120,
"280","1990","55-59",242,130,112,
"280","1990","60-64",221,107,114,
"280","1990","65-69",193,110,83,
"280","1990","70-74",126,65,61,
"280","1990","75-79",106,50,56,
"280","1990","80-84",43,16,27,
"280","1990","85+",36,16,20,
"282","1990","0-4",58,22,36,
"282","1990","5-9",71,37,34,
"282","1990","10-14",52,28,24,
"282","1990","15-19",48,23,25,
"282","1990","20-24",48,28,20,
"282","1990","25-29",71,36,35,
"282","1990","30-34",80,54,26,
"282","1990","35-39",68,39,29,
"282","1990","40-44",55,31,24,
"282","1990","45-49",43,28,15,
"282","1990","50-54",31,18,13,
"282","1990","55-59",21,9,12,
"282","1990","60-64",25,14,11,
"282","1990","65-69",18,13,5,
"282","1990","70-74",5,2,3,
"282","1990","75-79",7,3,4,
"282","1990","80-84",3,0,3,
"282","1990","85+",1,0,1,
"290","1990","0-4",784,410,374,
"290","1990","5-9",743,397,346,
"290","1990","10-14",608,324,284,
"290","1990","15-19",430,236,194,
"290","1990","20-24",390,230,160,
"290","1990","25-29",627,379,248,
"290","1990","30-34",654,360,294,
"290","1990","35-39",646,366,280,
"290","1990","40-44",490,301,189,
"290","1990","45-49",326,201,125,
"290","1990","50-54",252,145,107,
"290","1990","55-59",221,120,101,
"290","1990","60-64",187,109,78,
"290","1990","65-69",119,74,45,
"290","1990","70-74",93,49,44,
"290","1990","75-79",77,42,35,
"290","1990","80-84",46,24,22,
"290","1990","85+",21,12,9,
"000","1991","0-4",57083,29195,27888,
"000","1991","5-9",53476,27583,25893,
"000","1991","10-14",45942,23760,22182,
"000","1991","15-19",37697,20093,17604,
"000","1991","20-24",42418,23471,18947,
"000","1991","25-29",51181,26984,24197,
"000","1991","30-34",59627,30905,28722,
"000","1991","35-39",59299,31185,28114,
"000","1991","40-44",50169,27261,22908,
"000","1991","45-49",33440,18115,15325,
"000","1991","50-54",23758,13019,10739,
"000","1991","55-59",17149,9140,8009,
"000","1991","60-64",13488,7158,6330,
"000","1991","65-69",10253,5140,5113,
"000","1991","70-74",6558,3148,3410,
"000","1991","75-79",3978,1871,2107,
"000","1991","80-84",2150,839,1311,
"000","1991","85+",1388,526,862,
"013","1991","0-4",148,67,81,
"013","1991","5-9",154,86,68,
"013","1991","10-14",121,64,57,
"013","1991","15-19",125,82,43,
"013","1991","20-24",256,185,71,
"013","1991","25-29",325,224,101,
"013","1991","30-34",289,191,98,
"013","1991","35-39",245,178,67,
"013","1991","40-44",179,111,68,
"013","1991","45-49",132,82,50,
"013","1991","50-54",125,64,61,
"013","1991","55-59",82,61,21,
"013","1991","60-64",58,39,19,
"013","1991","65-69",23,14,9,
"013","1991","70-74",15,10,5,
"013","1991","75-79",6,3,3,
"013","1991","80-84",0,0,0,
"013","1991","85+",1,1,0,
"016","1991","0-4",810,458,352,
"016","1991","5-9",533,315,218,
"016","1991","10-14",381,186,195,
"016","1991","15-19",743,502,241,
"016","1991","20-24",1826,1331,495,
"016","1991","25-29",1522,1041,481,
"016","1991","30-34",1229,781,448,
"016","1991","35-39",1056,786,270,
"016","1991","40-44",641,423,218,
"016","1991","45-49",354,232,122,
"016","1991","50-54",220,161,59,
"016","1991","55-59",148,92,56,
"016","1991","60-64",83,55,28,
"016","1991","65-69",45,27,18,
"016","1991","70-74",22,13,9,
"016","1991","75-79",18,8,10,
"016","1991","80-84",9,3,6,
"016","1991","85+",3,3,0,
"020","1991","0-4",22816,11659,11157,
"020","1991","5-9",20614,10482,10132,
"020","1991","10-14",17490,9084,8406,
"020","1991","15-19",15138,7972,7166,
"020","1991","20-24",18725,10058,8667,
"020","1991","25-29",22681,11549,11132,
"020","1991","30-34",25512,12926,12586,
"020","1991","35-39",24972,12716,12256,
"020","1991","40-44",21167,11123,10044,
"020","1991","45-49",14577,7571,7006,
"020","1991","50-54",10108,5289,4819,
"020","1991","55-59",7290,3757,3533,
"020","1991","60-64",5430,2756,2674,
"020","1991","65-69",4062,1898,2164,
"020","1991","70-74",2515,1170,1345,
"020","1991","75-79",1348,602,746,
"020","1991","80-84",744,253,491,
"020","1991","85+",437,119,318,
"050","1991","0-4",1852,942,910,
"050","1991","5-9",1676,868,808,
"050","1991","10-14",1278,646,632,
"050","1991","15-19",1122,561,561,
"050","1991","20-24",1029,512,517,
"050","1991","25-29",1341,731,610,
"050","1991","30-34",1204,652,552,
"050","1991","35-39",1079,591,488,
"050","1991","40-44",842,481,361,
"050","1991","45-49",688,384,304,
"050","1991","50-54",445,210,235,
"050","1991","55-59",448,236,212,
"050","1991","60-64",296,167,129,
"050","1991","65-69",243,128,115,
"050","1991","70-74",179,76,103,
"050","1991","75-79",151,81,70,
"050","1991","80-84",53,30,23,
"050","1991","85+",48,31,17,
"060","1991","0-4",129,60,69,
"060","1991","5-9",118,62,56,
"060","1991","10-14",94,44,50,
"060","1991","15-19",66,36,30,
"060","1991","20-24",122,79,43,
"060","1991","25-29",174,117,57,
"060","1991","30-34",219,153,66,
"060","1991","35-39",182,115,67,
"060","1991","40-44",103,55,48,
"060","1991","45-49",80,51,29,
"060","1991","50-54",60,35,25,
"060","1991","55-59",43,31,12,
"060","1991","60-64",37,18,19,
"060","1991","65-69",18,10,8,
"060","1991","70-74",10,4,6,
"060","1991","75-79",6,3,3,
"060","1991","80-84",4,1,3,
"060","1991","85+",3,1,2,
"068","1991","0-4",147,91,56,
"068","1991","5-9",143,74,69,
"068","1991","10-14",139,70,69,
"068","1991","15-19",98,54,44,
"068","1991","20-24",90,54,36,
"068","1991","25-29",122,71,51,
"068","1991","30-34",208,120,88,
"068","1991","35-39",212,113,99,
"068","1991","40-44",203,119,84,
"068","1991","45-49",142,93,49,
"068","1991","50-54",125,87,38,
"068","1991","55-59",78,53,25,
"068","1991","60-64",30,22,8,
"068","1991","65-69",18,10,8,
"068","1991","70-74",16,12,4,
"068","1991","75-79",6,3,3,
"068","1991","80-84",3,1,2,
"068","1991","85+",1,1,0,
"070","1991","0-4",587,305,282,
"070","1991","5-9",476,240,236,
"070","1991","10-14",370,184,186,
"070","1991","15-19",264,142,122,
"070","1991","20-24",234,112,122,
"070","1991","25-29",361,179,182,
"070","1991","30-34",411,229,182,
"070","1991","35-39",408,198,210,
"070","1991","40-44",264,155,109,
"070","1991","45-49",216,121,95,
"070","1991","50-54",158,76,82,
"070","1991","55-59",121,63,58,
"070","1991","60-64",93,50,43,
"070","1991","65-69",84,39,45,
"070","1991","70-74",45,20,25,
"070","1991","75-79",32,15,17,
"070","1991","80-84",26,14,12,
"070","1991","85+",19,9,10,
"090","1991","0-4",8357,4289,4068,
"090","1991","5-9",7729,4007,3722,
"090","1991","10-14",6397,3345,3052,
"090","1991","15-19",5504,2947,2557,
"090","1991","20-24",7775,4577,3198,
"090","1991","25-29",8049,4283,3766,
"090","1991","30-34",8489,4355,4134,
"090","1991","35-39",8117,4275,3842,
"090","1991","40-44",6750,3707,3043,
"090","1991","45-49",4184,2270,1914,
"090","1991","50-54",2887,1598,1289,
"090","1991","55-59",2006,1064,942,
"090","1991","60-64",1607,876,731,
"090","1991","65-69",1165,571,594,
"090","1991","70-74",749,356,393,
"090","1991","75-79",506,251,255,
"090","1991","80-84",223,88,135,
"090","1991","85+",161,59,102,
"100","1991","0-4",176,93,83,
"100","1991","5-9",188,97,91,
"100","1991","10-14",181,88,93,
"100","1991","15-19",155,93,62,
"100","1991","20-24",87,48,39,
"100","1991","25-29",145,76,69,
"100","1991","30-34",203,112,91,
"100","1991","35-39",244,126,118,
"100","1991","40-44",232,127,105,
"100","1991","45-49",165,88,77,
"100","1991","50-54",113,57,56,
"100","1991","55-59",91,50,41,
"100","1991","60-64",72,42,30,
"100","1991","65-69",75,46,29,
"100","1991","70-74",59,26,33,
"100","1991","75-79",41,19,22,
"100","1991","80-84",14,3,11,
"100","1991","85+",1,0,1,
"110","1991","0-4",2442,1243,1199,
"110","1991","5-9",2449,1268,1181,
"110","1991","10-14",2136,1100,1036,
"110","1991","15-19",1647,851,796,
"110","1991","20-24",1610,791,819,
"110","1991","25-29",2213,1101,1112,
"110","1991","30-34",2869,1440,1429,
"110","1991","35-39",3113,1533,1580,
"110","1991","40-44",2992,1561,1431,
"110","1991","45-49",1828,980,848,
"110","1991","50-54",1335,735,600,
"110","1991","55-59",814,418,396,
"110","1991","60-64",684,356,328,
"110","1991","65-69",500,234,266,
"110","1991","70-74",431,177,254,
"110","1991","75-79",261,118,143,
"110","1991","80-84",159,61,98,
"110","1991","85+",96,42,54,
"122","1991","0-4",3969,1972,1997,
"122","1991","5-9",4153,2162,1991,
"122","1991","10-14",3731,1932,1799,
"122","1991","15-19",2972,1609,1363,
"122","1991","20-24",2213,1186,1027,
"122","1991","25-29",2853,1524,1329,
"122","1991","30-34",4109,2109,2000,
"122","1991","35-39",4715,2483,2232,
"122","1991","40-44",4062,2272,1790,
"122","1991","45-49",2704,1514,1190,
"122","1991","50-54",1765,966,799,
"122","1991","55-59",1461,772,689,
"122","1991","60-64",1198,642,556,
"122","1991","65-69",1017,548,469,
"122","1991","70-74",650,329,321,
"122","1991","75-79",285,151,134,
"122","1991","80-84",182,87,95,
"122","1991","85+",93,33,60,
"130","1991","0-4",1248,645,603,
"130","1991","5-9",1220,635,585,
"130","1991","10-14",1161,601,560,
"130","1991","15-19",898,473,425,
"130","1991","20-24",930,500,430,
"130","1991","25-29",1068,563,505,
"130","1991","30-34",1380,702,678,
"130","1991","35-39",1401,746,655,
"130","1991","40-44",1335,692,643,
"130","1991","45-49",961,498,463,
"130","1991","50-54",749,444,305,
"130","1991","55-59",485,269,216,
"130","1991","60-64",451,238,213,
"130","1991","65-69",356,184,172,
"130","1991","70-74",249,114,135,
"130","1991","75-79",181,87,94,
"130","1991","80-84",96,34,62,
"130","1991","85+",86,35,51,
"150","1991","0-4",1423,716,707,
"150","1991","5-9",1150,611,539,
"150","1991","10-14",1044,526,518,
"150","1991","15-19",819,456,363,
"150","1991","20-24",1048,649,399,
"150","1991","25-29",1267,715,552,
"150","1991","30-34",1527,874,653,
"150","1991","35-39",1432,797,635,
"150","1991","40-44",1121,628,493,
"150","1991","45-49",712,417,295,
"150","1991","50-54",450,252,198,
"150","1991","55-59",326,189,137,
"150","1991","60-64",266,154,112,
"150","1991","65-69",165,86,79,
"150","1991","70-74",119,70,49,
"150","1991","75-79",84,30,54,
"150","1991","80-84",35,12,23,
"150","1991","85+",30,9,21,
"164","1991","0-4",234,112,122,
"164","1991","5-9",208,96,112,
"164","1991","10-14",166,85,81,
"164","1991","15-19",103,50,53,
"164","1991","20-24",77,44,33,
"164","1991","25-29",157,81,76,
"164","1991","30-34",191,112,79,
"164","1991","35-39",152,82,70,
"164","1991","40-44",98,61,37,
"164","1991","45-49",82,52,30,
"164","1991","50-54",64,35,29,
"164","1991","55-59",57,34,23,
"164","1991","60-64",50,30,20,
"164","1991","65-69",43,25,18,
"164","1991","70-74",21,10,11,
"164","1991","75-79",18,8,10,
"164","1991","80-84",12,8,4,
"164","1991","85+",4,2,2,
"170","1991","0-4",3887,2030,1857,
"170","1991","5-9",4619,2394,2225,
"170","1991","10-14",4318,2176,2142,
"170","1991","15-19",2785,1435,1350,
"170","1991","20-24",1709,862,847,
"170","1991","25-29",2614,1264,1350,
"170","1991","30-34",4364,2148,2216,
"170","1991","35-39",4812,2512,2300,
"170","1991","40-44",4075,2254,1821,
"170","1991","45-49",2400,1344,1056,
"170","1991","50-54",1780,1018,762,
"170","1991","55-59",1271,686,585,
"170","1991","60-64",1143,629,514,
"170","1991","65-69",906,478,428,
"170","1991","70-74",548,286,262,
"170","1991","75-79",313,147,166,
"170","1991","80-84",172,81,91,
"170","1991","85+",103,46,57,
"180","1991","0-4",1159,567,592,
"180","1991","5-9",946,478,468,
"180","1991","10-14",768,407,361,
"180","1991","15-19",670,357,313,
"180","1991","20-24",534,277,257,
"180","1991","25-29",701,403,298,
"180","1991","30-34",812,427,385,
"180","1991","35-39",696,404,292,
"180","1991","40-44",604,377,227,
"180","1991","45-49",399,219,180,
"180","1991","50-54",311,176,135,
"180","1991","55-59",268,160,108,
"180","1991","60-64",199,96,103,
"180","1991","65-69",157,92,65,
"180","1991","70-74",110,60,50,
"180","1991","75-79",100,42,58,
"180","1991","80-84",56,17,39,
"180","1991","85+",32,16,16,
"185","1991","0-4",893,433,460,
"185","1991","5-9",709,363,346,
"185","1991","10-14",545,281,264,
"185","1991","15-19",355,180,175,
"185","1991","20-24",385,191,194,
"185","1991","25-29",612,323,289,
"185","1991","30-34",594,327,267,
"185","1991","35-39",519,309,210,
"185","1991","40-44",414,260,154,
"185","1991","45-49",333,204,129,
"185","1991","50-54",270,157,113,
"185","1991","55-59",202,113,89,
"185","1991","60-64",139,85,54,
"185","1991","65-69",85,42,43,
"185","1991","70-74",48,24,24,
"185","1991","75-79",43,18,25,
"185","1991","80-84",28,11,17,
"185","1991","85+",8,3,5,
"188","1991","0-4",1028,528,500,
"188","1991","5-9",756,398,358,
"188","1991","10-14",610,312,298,
"188","1991","15-19",492,277,215,
"188","1991","20-24",422,212,210,
"188","1991","25-29",577,320,257,
"188","1991","30-34",523,285,238,
"188","1991","35-39",423,237,186,
"188","1991","40-44",329,195,134,
"188","1991","45-49",240,123,117,
"188","1991","50-54",195,120,75,
"188","1991","55-59",156,80,76,
"188","1991","60-64",160,81,79,
"188","1991","65-69",102,46,56,
"188","1991","70-74",61,35,26,
"188","1991","75-79",51,22,29,
"188","1991","80-84",35,11,24,
"188","1991","85+",31,12,19,
"201","1991","0-4",641,329,312,
"201","1991","5-9",633,306,327,
"201","1991","10-14",597,332,265,
"201","1991","15-19",412,228,184,
"201","1991","20-24",415,219,196,
"201","1991","25-29",535,302,233,
"201","1991","30-34",640,337,303,
"201","1991","35-39",689,415,274,
"201","1991","40-44",609,344,265,
"201","1991","45-49",433,276,157,
"201","1991","50-54",347,218,129,
"201","1991","55-59",201,124,77,
"201","1991","60-64",170,101,69,
"201","1991","65-69",96,57,39,
"201","1991","70-74",58,32,26,
"201","1991","75-79",29,18,11,
"201","1991","80-84",26,11,15,
"201","1991","85+",20,8,12,
"220","1991","0-4",786,387,399,
"220","1991","5-9",818,413,405,
"220","1991","10-14",790,443,347,
"220","1991","15-19",578,324,254,
"220","1991","20-24",568,319,249,
"220","1991","25-29",719,376,343,
"220","1991","30-34",913,462,451,
"220","1991","35-39",892,429,463,
"220","1991","40-44",758,431,327,
"220","1991","45-49",526,291,235,
"220","1991","50-54",446,250,196,
"220","1991","55-59",308,160,148,
"220","1991","60-64",244,131,113,
"220","1991","65-69",186,84,102,
"220","1991","70-74",128,58,70,
"220","1991","75-79",94,46,48,
"220","1991","80-84",64,26,38,
"220","1991","85+",60,14,46,
"232","1991","0-4",337,171,166,
"232","1991","5-9",373,208,165,
"232","1991","10-14",341,169,172,
"232","1991","15-19",253,130,123,
"232","1991","20-24",166,82,84,
"232","1991","25-29",254,148,106,
"232","1991","30-34",389,228,161,
"232","1991","35-39",378,215,163,
"232","1991","40-44",338,191,147,
"232","1991","45-49",230,115,115,
"232","1991","50-54",175,111,64,
"232","1991","55-59",135,86,49,
"232","1991","60-64",97,51,46,
"232","1991","65-69",91,50,41,
"232","1991","70-74",60,30,30,
"232","1991","75-79",33,14,19,
"232","1991","80-84",19,6,13,
"232","1991","85+",10,6,4,
"240","1991","0-4",582,287,295,
"240","1991","5-9",607,337,270,
"240","1991","10-14",653,358,295,
"240","1991","15-19",444,262,182,
"240","1991","20-24",368,193,175,
"240","1991","25-29",408,222,186,
"240","1991","30-34",612,322,290,
"240","1991","35-39",586,298,288,
"240","1991","40-44",559,300,259,
"240","1991","45-49",331,185,146,
"240","1991","50-54",304,187,117,
"240","1991","55-59",171,90,81,
"240","1991","60-64",134,74,60,
"240","1991","65-69",114,72,42,
"240","1991","70-74",55,28,27,
"240","1991","75-79",42,15,27,
"240","1991","80-84",15,8,7,
"240","1991","85+",24,10,14,
"261","1991","0-4",862,434,428,
"261","1991","5-9",914,485,429,
"261","1991","10-14",799,425,374,
"261","1991","15-19",585,293,292,
"261","1991","20-24",584,327,257,
"261","1991","25-29",787,433,354,
"261","1991","30-34",1042,568,474,
"261","1991","35-39",1174,635,539,
"261","1991","40-44",985,541,444,
"261","1991","45-49",666,385,281,
"261","1991","50-54",521,302,219,
"261","1991","55-59",335,198,137,
"261","1991","60-64",285,174,111,
"261","1991","65-69",194,107,87,
"261","1991","70-74",129,60,69,
"261","1991","75-79",87,51,36,
"261","1991","80-84",38,16,22,
"261","1991","85+",40,25,15,
"270","1991","0-4",1087,584,503,
"270","1991","5-9",794,395,399,
"270","1991","10-14",581,286,295,
"270","1991","15-19",508,239,269,
"270","1991","20-24",480,232,248,
"270","1991","25-29",514,283,231,
"270","1991","30-34",449,246,203,
"270","1991","35-39",348,186,162,
"270","1991","40-44",302,162,140,
"270","1991","45-49",214,124,90,
"270","1991","50-54",182,112,70,
"270","1991","55-59",190,91,99,
"270","1991","60-64",130,65,65,
"270","1991","65-69",134,75,59,
"270","1991","70-74",62,30,32,
"270","1991","75-79",40,22,18,
"270","1991","80-84",28,12,16,
"270","1991","85+",20,14,6,
"280","1991","0-4",676,372,304,
"280","1991","5-9",698,367,331,
"280","1991","10-14",552,257,295,
"280","1991","15-19",439,235,204,
"280","1991","20-24",380,214,166,
"280","1991","25-29",513,269,244,
"280","1991","30-34",735,392,343,
"280","1991","35-39",768,405,363,
"280","1991","40-44",637,365,272,
"280","1991","45-49",452,257,195,
"280","1991","50-54",333,194,139,
"280","1991","55-59",223,128,95,
"280","1991","60-64",222,112,110,
"280","1991","65-69",210,113,97,
"280","1991","70-74",124,68,56,
"280","1991","75-79",114,46,68,
"280","1991","80-84",63,24,39,
"280","1991","85+",32,13,19,
"282","1991","0-4",61,26,35,
"282","1991","5-9",58,29,29,
"282","1991","10-14",52,28,24,
"282","1991","15-19",43,25,18,
"282","1991","20-24",57,30,27,
"282","1991","25-29",68,36,32,
"282","1991","30-34",91,66,25,
"282","1991","35-39",75,40,35,
"282","1991","40-44",55,33,22,
"282","1991","45-49",47,27,20,
"282","1991","50-54",41,25,16,
"282","1991","55-59",19,7,12,
"282","1991","60-64",21,14,7,
"282","1991","65-69",21,13,8,
"282","1991","70-74",3,2,1,
"282","1991","75-79",6,2,4,
"282","1991","80-84",4,1,3,
"282","1991","85+",0,0,0,
"290","1991","0-4",746,395,351,
"290","1991","5-9",740,407,333,
"290","1991","10-14",647,331,316,
"290","1991","15-19",479,280,199,
"290","1991","20-24",328,187,141,
"290","1991","25-29",601,350,251,
"290","1991","30-34",623,341,282,
"290","1991","35-39",611,361,250,
"290","1991","40-44",515,293,222,
"290","1991","45-49",344,212,132,
"290","1991","50-54",249,140,109,
"290","1991","55-59",220,128,92,
"290","1991","60-64",189,100,89,
"290","1991","65-69",143,91,52,
"290","1991","70-74",92,48,44,
"290","1991","75-79",83,49,34,
"290","1991","80-84",42,20,22,
"290","1991","85+",25,14,11,
"000","1992","0-4",57913,29495,28418,
"000","1992","5-9",54625,28084,26541,
"000","1992","10-14",48707,25308,23399,
"000","1992","15-19",38846,20614,18232,
"000","1992","20-24",42398,23499,18899,
"000","1992","25-29",49688,26292,23396,
"000","1992","30-34",59837,30901,28936,
"000","1992","35-39",61289,32085,29204,
"000","1992","40-44",52194,28119,24075,
"000","1992","45-49",37672,20411,17261,
"000","1992","50-54",25659,14070,11589,
"000","1992","55-59",18033,9618,8415,
"000","1992","60-64",13904,7332,6572,
"000","1992","65-69",10682,5370,5312,
"000","1992","70-74",7212,3444,3768,
"000","1992","75-79",4192,1942,2250,
"000","1992","80-84",2339,934,1405,
"000","1992","85+",1532,559,973,
"013","1992","0-4",162,72,90,
"013","1992","5-9",163,86,77,
"013","1992","10-14",127,66,61,
"013","1992","15-19",139,99,40,
"013","1992","20-24",230,174,56,
"013","1992","25-29",302,199,103,
"013","1992","30-34",295,204,91,
"013","1992","35-39",252,184,68,
"013","1992","40-44",181,104,77,
"013","1992","45-49",150,91,59,
"013","1992","50-54",119,59,60,
"013","1992","55-59",88,64,24,
"013","1992","60-64",59,40,19,
"013","1992","65-69",19,11,8,
"013","1992","70-74",15,10,5,
"013","1992","75-79",13,5,8,
"013","1992","80-84",0,0,0,
"013","1992","85+",1,0,1,
"016","1992","0-4",816,470,346,
"016","1992","5-9",569,323,246,
"016","1992","10-14",432,220,212,
"016","1992","15-19",699,466,233,
"016","1992","20-24",1828,1276,552,
"016","1992","25-29",1584,1057,527,
"016","1992","30-34",1228,730,498,
"016","1992","35-39",1109,848,261,
"016","1992","40-44",654,437,217,
"016","1992","45-49",380,244,136,
"016","1992","50-54",235,175,60,
"016","1992","55-59",133,80,53,
"016","1992","60-64",74,54,20,
"016","1992","65-69",36,18,18,
"016","1992","70-74",23,14,9,
"016","1992","75-79",10,4,6,
"016","1992","80-84",15,11,4,
"016","1992","85+",5,3,2,
"020","1992","0-4",23417,11987,11430,
"020","1992","5-9",21310,10806,10504,
"020","1992","10-14",18558,9666,8892,
"020","1992","15-19",15528,8115,7413,
"020","1992","20-24",18834,10113,8721,
"020","1992","25-29",22043,11355,10688,
"020","1992","30-34",25994,13122,12872,
"020","1992","35-39",25895,13141,12754,
"020","1992","40-44",21848,11375,10473,
"020","1992","45-49",16484,8617,7867,
"020","1992","50-54",11002,5788,5214,
"020","1992","55-59",7685,4002,3683,
"020","1992","60-64",5674,2842,2832,
"020","1992","65-69",4262,2024,2238,
"020","1992","70-74",2798,1280,1518,
"020","1992","75-79",1437,636,801,
"020","1992","80-84",835,276,559,
"020","1992","85+",507,145,362,
"050","1992","0-4",1968,976,992,
"050","1992","5-9",1721,907,814,
"050","1992","10-14",1348,671,677,
"050","1992","15-19",1121,560,561,
"050","1992","20-24",1012,498,514,
"050","1992","25-29",1322,733,589,
"050","1992","30-34",1239,664,575,
"050","1992","35-39",1126,617,509,
"050","1992","40-44",881,497,384,
"050","1992","45-49",664,376,288,
"050","1992","50-54",512,249,263,
"050","1992","55-59",416,212,204,
"050","1992","60-64",333,186,147,
"050","1992","65-69",231,121,110,
"050","1992","70-74",181,84,97,
"050","1992","75-79",154,82,72,
"050","1992","80-84",66,36,30,
"050","1992","85+",45,28,17,
"060","1992","0-4",142,62,80,
"060","1992","5-9",122,66,56,
"060","1992","10-14",112,45,67,
"060","1992","15-19",80,45,35,
"060","1992","20-24",134,79,55,
"060","1992","25-29",174,119,55,
"060","1992","30-34",229,157,72,
"060","1992","35-39",187,111,76,
"060","1992","40-44",126,71,55,
"060","1992","45-49",78,47,31,
"060","1992","50-54",65,45,20,
"060","1992","55-59",36,21,15,
"060","1992","60-64",34,21,13,
"060","1992","65-69",24,12,12,
"060","1992","70-74",15,7,8,
"060","1992","75-79",5,3,2,
"060","1992","80-84",1,1,0,
"060","1992","85+",6,1,5,
"068","1992","0-4",141,87,54,
"068","1992","5-9",159,88,71,
"068","1992","10-14",150,77,73,
"068","1992","15-19",82,40,42,
"068","1992","20-24",84,55,29,
"068","1992","25-29",118,64,54,
"068","1992","30-34",200,115,85,
"068","1992","35-39",204,111,93,
"068","1992","40-44",214,132,82,
"068","1992","45-49",141,89,52,
"068","1992","50-54",132,93,39,
"068","1992","55-59",69,41,28,
"068","1992","60-64",25,19,6,
"068","1992","65-69",20,12,8,
"068","1992","70-74",17,13,4,
"068","1992","75-79",6,2,4,
"068","1992","80-84",3,2,1,
"068","1992","85+",1,1,0,
"070","1992","0-4",600,316,284,
"070","1992","5-9",490,251,239,
"070","1992","10-14",378,188,190,
"070","1992","15-19",258,136,122,
"070","1992","20-24",226,113,113,
"070","1992","25-29",338,160,178,
"070","1992","30-34",430,227,203,
"070","1992","35-39",407,212,195,
"070","1992","40-44",296,166,130,
"070","1992","45-49",207,117,90,
"070","1992","50-54",168,78,90,
"070","1992","55-59",135,71,64,
"070","1992","60-64",98,53,45,
"070","1992","65-69",85,41,44,
"070","1992","70-74",51,22,29,
"070","1992","75-79",33,18,15,
"070","1992","80-84",26,12,14,
"070","1992","85+",21,7,14,
"090","1992","0-4",7876,3937,3939,
"090","1992","5-9",7455,3873,3582,
"090","1992","10-14",6449,3387,3062,
"090","1992","15-19",5581,2990,2591,
"090","1992","20-24",7740,4692,3048,
"090","1992","25-29",7416,3992,3424,
"090","1992","30-34",8177,4239,3938,
"090","1992","35-39",8098,4154,3944,
"090","1992","40-44",6903,3806,3097,
"090","1992","45-49",4743,2593,2150,
"090","1992","50-54",3065,1683,1382,
"090","1992","55-59",2103,1109,994,
"090","1992","60-64",1673,908,765,
"090","1992","65-69",1192,599,593,
"090","1992","70-74",826,391,435,
"090","1992","75-79",532,262,270,
"090","1992","80-84",261,110,151,
"090","1992","85+",171,59,112,
"100","1992","0-4",181,101,80,
"100","1992","5-9",189,96,93,
"100","1992","10-14",193,94,99,
"100","1992","15-19",161,94,67,
"100","1992","20-24",77,41,36,
"100","1992","25-29",139,70,69,
"100","1992","30-34",184,99,85,
"100","1992","35-39",232,119,113,
"100","1992","40-44",234,130,104,
"100","1992","45-49",172,82,90,
"100","1992","50-54",115,61,54,
"100","1992","55-59",83,50,33,
"100","1992","60-64",71,33,38,
"100","1992","65-69",80,49,31,
"100","1992","70-74",62,33,29,
"100","1992","75-79",41,19,22,
"100","1992","80-84",15,5,10,
"100","1992","85+",1,0,1,
"110","1992","0-4",2463,1241,1222,
"110","1992","5-9",2522,1292,1230,
"110","1992","10-14",2252,1148,1104,
"110","1992","15-19",1713,864,849,
"110","1992","20-24",1550,745,805,
"110","1992","25-29",2149,1067,1082,
"110","1992","30-34",2811,1376,1435,
"110","1992","35-39",3153,1593,1560,
"110","1992","40-44",3037,1561,1476,
"110","1992","45-49",2083,1112,971,
"110","1992","50-54",1430,772,658,
"110","1992","55-59",900,471,429,
"110","1992","60-64",678,351,327,
"110","1992","65-69",524,242,282,
"110","1992","70-74",438,178,260,
"110","1992","75-79",280,123,157,
"110","1992","80-84",165,71,94,
"110","1992","85+",105,37,68,
"122","1992","0-4",3986,1983,2003,
"122","1992","5-9",4162,2167,1995,
"122","1992","10-14",4062,2112,1950,
"122","1992","15-19",3051,1646,1405,
"122","1992","20-24",2252,1229,1023,
"122","1992","25-29",2777,1470,1307,
"122","1992","30-34",4063,2056,2007,
"122","1992","35-39",4850,2507,2343,
"122","1992","40-44",4263,2335,1928,
"122","1992","45-49",3021,1699,1322,
"122","1992","50-54",1911,1049,862,
"122","1992","55-59",1482,776,706,
"122","1992","60-64",1189,622,567,
"122","1992","65-69",1049,572,477,
"122","1992","70-74",718,366,352,
"122","1992","75-79",319,159,160,
"122","1992","80-84",193,97,96,
"122","1992","85+",111,44,67,
"130","1992","0-4",1260,642,618,
"130","1992","5-9",1237,649,588,
"130","1992","10-14",1226,652,574,
"130","1992","15-19",965,514,451,
"130","1992","20-24",870,464,406,
"130","1992","25-29",1079,567,512,
"130","1992","30-34",1373,708,665,
"130","1992","35-39",1462,780,682,
"130","1992","40-44",1361,705,656,
"130","1992","45-49",1072,568,504,
"130","1992","50-54",794,450,344,
"130","1992","55-59",505,282,223,
"130","1992","60-64",438,238,200,
"130","1992","65-69",362,188,174,
"130","1992","70-74",263,114,149,
"130","1992","75-79",183,83,100,
"130","1992","80-84",97,42,55,
"130","1992","85+",89,35,54,
"150","1992","0-4",1590,789,801,
"150","1992","5-9",1324,696,628,
"150","1992","10-14",1175,581,594,
"150","1992","15-19",939,505,434,
"150","1992","20-24",1101,649,452,
"150","1992","25-29",1389,785,604,
"150","1992","30-34",1669,984,685,
"150","1992","35-39",1594,881,713,
"150","1992","40-44",1279,727,552,
"150","1992","45-49",878,504,374,
"150","1992","50-54",524,300,224,
"150","1992","55-59",382,216,166,
"150","1992","60-64",284,161,123,
"150","1992","65-69",207,106,101,
"150","1992","70-74",139,85,54,
"150","1992","75-79",90,35,55,
"150","1992","80-84",44,14,30,
"150","1992","85+",27,10,17,
"164","1992","0-4",246,118,128,
"164","1992","5-9",222,107,115,
"164","1992","10-14",173,95,78,
"164","1992","15-19",114,53,61,
"164","1992","20-24",75,42,33,
"164","1992","25-29",170,89,81,
"164","1992","30-34",187,110,77,
"164","1992","35-39",152,82,70,
"164","1992","40-44",126,72,54,
"164","1992","45-49",74,48,26,
"164","1992","50-54",67,32,35,
"164","1992","55-59",56,34,22,
"164","1992","60-64",53,30,23,
"164","1992","65-69",42,25,17,
"164","1992","70-74",16,7,9,
"164","1992","75-79",14,8,6,
"164","1992","80-84",15,7,8,
"164","1992","85+",3,2,1,
"170","1992","0-4",4049,2139,1910,
"170","1992","5-9",4708,2387,2321,
"170","1992","10-14",4699,2449,2250,
"170","1992","15-19",3019,1563,1456,
"170","1992","20-24",1813,928,885,
"170","1992","25-29",2599,1252,1347,
"170","1992","30-34",4401,2139,2262,
"170","1992","35-39",5124,2662,2462,
"170","1992","40-44",4419,2404,2015,
"170","1992","45-49",2776,1537,1239,
"170","1992","50-54",2009,1185,824,
"170","1992","55-59",1323,703,620,
"170","1992","60-64",1214,663,551,
"170","1992","65-69",966,509,457,
"170","1992","70-74",605,307,298,
"170","1992","75-79",355,164,191,
"170","1992","80-84",174,76,98,
"170","1992","85+",117,53,64,
"180","1992","0-4",1252,594,658,
"180","1992","5-9",955,487,468,
"180","1992","10-14",819,428,391,
"180","1992","15-19",650,352,298,
"180","1992","20-24",545,273,272,
"180","1992","25-29",736,427,309,
"180","1992","30-34",814,451,363,
"180","1992","35-39",722,401,321,
"180","1992","40-44",628,363,265,
"180","1992","45-49",456,256,200,
"180","1992","50-54",323,181,142,
"180","1992","55-59",279,162,117,
"180","1992","60-64",213,107,106,
"180","1992","65-69",155,86,69,
"180","1992","70-74",112,61,51,
"180","1992","75-79",101,45,56,
"180","1992","80-84",60,20,40,
"180","1992","85+",28,14,14,
"185","1992","0-4",950,496,454,
"185","1992","5-9",743,380,363,
"185","1992","10-14",602,302,300,
"185","1992","15-19",380,189,191,
"185","1992","20-24",374,199,175,
"185","1992","25-29",579,297,282,
"185","1992","30-34",625,325,300,
"185","1992","35-39",571,355,216,
"185","1992","40-44",469,272,197,
"185","1992","45-49",376,231,145,
"185","1992","50-54",268,151,117,
"185","1992","55-59",206,117,89,
"185","1992","60-64",142,87,55,
"185","1992","65-69",88,49,39,
"185","1992","70-74",50,25,25,
"185","1992","75-79",40,16,24,
"185","1992","80-84",24,8,16,
"185","1992","85+",13,6,7,
"188","1992","0-4",1094,554,540,
"188","1992","5-9",814,443,371,
"188","1992","10-14",652,330,322,
"188","1992","15-19",501,273,228,
"188","1992","20-24",428,226,202,
"188","1992","25-29",588,324,264,
"188","1992","30-34",557,308,249,
"188","1992","35-39",440,240,200,
"188","1992","40-44",350,215,135,
"188","1992","45-49",278,139,139,
"188","1992","50-54",198,122,76,
"188","1992","55-59",172,83,89,
"188","1992","60-64",173,98,75,
"188","1992","65-69",112,52,60,
"188","1992","70-74",67,33,34,
"188","1992","75-79",52,23,29,
"188","1992","80-84",27,9,18,
"188","1992","85+",33,12,21,
"201","1992","0-4",644,336,308,
"201","1992","5-9",629,299,330,
"201","1992","10-14",638,342,296,
"201","1992","15-19",386,214,172,
"201","1992","20-24",379,188,191,
"201","1992","25-29",491,281,210,
"201","1992","30-34",638,325,313,
"201","1992","35-39",654,384,270,
"201","1992","40-44",646,362,284,
"201","1992","45-49",483,303,180,
"201","1992","50-54",352,213,139,
"201","1992","55-59",239,157,82,
"201","1992","60-64",165,94,71,
"201","1992","65-69",115,65,50,
"201","1992","70-74",73,41,32,
"201","1992","75-79",28,17,11,
"201","1992","80-84",28,12,16,
"201","1992","85+",20,9,11,
"220","1992","0-4",753,375,378,
"220","1992","5-9",790,383,407,
"220","1992","10-14",828,461,367,
"220","1992","15-19",596,346,250,
"220","1992","20-24",586,321,265,
"220","1992","25-29",691,364,327,
"220","1992","30-34",889,466,423,
"220","1992","35-39",930,462,468,
"220","1992","40-44",789,441,348,
"220","1992","45-49",587,310,277,
"220","1992","50-54",448,257,191,
"220","1992","55-59",346,183,163,
"220","1992","60-64",256,136,120,
"220","1992","65-69",195,87,108,
"220","1992","70-74",137,56,81,
"220","1992","75-79",99,51,48,
"220","1992","80-84",73,32,41,
"220","1992","85+",66,13,53,
"232","1992","0-4",324,161,163,
"232","1992","5-9",377,204,173,
"232","1992","10-14",372,189,183,
"232","1992","15-19",266,135,131,
"232","1992","20-24",156,76,80,
"232","1992","25-29",241,143,98,
"232","1992","30-34",383,221,162,
"232","1992","35-39",405,235,170,
"232","1992","40-44",358,195,163,
"232","1992","45-49",269,138,131,
"232","1992","50-54",189,119,70,
"232","1992","55-59",146,90,56,
"232","1992","60-64",94,51,43,
"232","1992","65-69",84,44,40,
"232","1992","70-74",72,37,35,
"232","1992","75-79",32,12,20,
"232","1992","80-84",19,5,14,
"232","1992","85+",14,7,7,
"240","1992","0-4",583,271,312,
"240","1992","5-9",579,332,247,
"240","1992","10-14",680,359,321,
"240","1992","15-19",479,276,203,
"240","1992","20-24",360,199,161,
"240","1992","25-29",361,187,174,
"240","1992","30-34",555,299,256,
"240","1992","35-39",648,326,322,
"240","1992","40-44",546,292,254,
"240","1992","45-49",372,205,167,
"240","1992","50-54",332,203,129,
"240","1992","55-59",201,98,103,
"240","1992","60-64",147,89,58,
"240","1992","65-69",123,78,45,
"240","1992","70-74",70,33,37,
"240","1992","75-79",45,15,30,
"240","1992","80-84",17,10,7,
"240","1992","85+",22,9,13,
"261","1992","0-4",852,434,418,
"261","1992","5-9",968,507,461,
"261","1992","10-14",840,438,402,
"261","1992","15-19",623,324,299,
"261","1992","20-24",550,306,244,
"261","1992","25-29",753,391,362,
"261","1992","30-34",1022,558,464,
"261","1992","35-39",1234,666,568,
"261","1992","40-44",1012,569,443,
"261","1992","45-49",755,434,321,
"261","1992","50-54",545,308,237,
"261","1992","55-59",355,218,137,
"261","1992","60-64",262,163,99,
"261","1992","65-69",209,110,99,
"261","1992","70-74",138,68,70,
"261","1992","75-79",83,42,41,
"261","1992","80-84",41,22,19,
"261","1992","85+",36,20,16,
"270","1992","0-4",1139,593,546,
"270","1992","5-9",848,433,415,
"270","1992","10-14",615,304,311,
"270","1992","15-19",533,265,268,
"270","1992","20-24",459,215,244,
"270","1992","25-29",541,289,252,
"270","1992","30-34",465,252,213,
"270","1992","35-39",363,204,159,
"270","1992","40-44",292,152,140,
"270","1992","45-49",235,137,98,
"270","1992","50-54",178,108,70,
"270","1992","55-59",205,97,108,
"270","1992","60-64",126,61,65,
"270","1992","65-69",143,76,67,
"270","1992","70-74",66,30,36,
"270","1992","75-79",38,21,17,
"270","1992","80-84",29,11,18,
"270","1992","85+",19,14,5,
"280","1992","0-4",635,345,290,
"280","1992","5-9",718,367,351,
"280","1992","10-14",595,302,293,
"280","1992","15-19",439,227,212,
"280","1992","20-24",375,199,176,
"280","1992","25-29",506,264,242,
"280","1992","30-34",726,385,341,
"280","1992","35-39",777,399,378,
"280","1992","40-44",665,388,277,
"280","1992","45-49",512,277,235,
"280","1992","50-54",372,223,149,
"280","1992","55-59",231,130,101,
"280","1992","60-64",227,116,111,
"280","1992","65-69",187,93,94,
"280","1992","70-74",159,91,68,
"280","1992","75-79",119,52,67,
"280","1992","80-84",63,22,41,
"280","1992","85+",39,16,23,
"282","1992","0-4",54,30,24,
"282","1992","5-9",66,30,36,
"282","1992","10-14",52,33,19,
"282","1992","15-19",41,28,13,
"282","1992","20-24",39,19,20,
"282","1992","25-29",46,19,27,
"282","1992","30-34",71,45,26,
"282","1992","35-39",73,41,32,
"282","1992","40-44",61,36,25,
"282","1992","45-49",56,31,25,
"282","1992","50-54",34,24,10,
"282","1992","55-59",24,10,14,
"282","1992","60-64",21,12,9,
"282","1992","65-69",25,15,10,
"282","1992","70-74",6,4,2,
"282","1992","75-79",5,1,4,
"282","1992","80-84",4,2,2,
"282","1992","85+",2,0,2,
"290","1992","0-4",736,386,350,
"290","1992","5-9",785,425,360,
"290","1992","10-14",680,369,311,
"290","1992","15-19",502,295,207,
"290","1992","20-24",321,180,141,
"290","1992","25-29",556,327,229,
"290","1992","30-34",612,336,276,
"290","1992","35-39",627,370,257,
"290","1992","40-44",556,312,244,
"290","1992","45-49",370,226,144,
"290","1992","50-54",272,142,130,
"290","1992","55-59",233,141,92,
"290","1992","60-64",181,97,84,
"290","1992","65-69",147,86,61,
"290","1992","70-74",95,54,41,
"290","1992","75-79",78,44,34,
"290","1992","80-84",44,21,23,
"290","1992","85+",30,14,57913,
"000","1993","0-4",57494,29464,28030,
"000","1993","5-9",55168,28276,26892,
"000","1993","10-14",51610,26767,24843,
"000","1993","15-19",40090,21298,18792,
"000","1993","20-24",41805,22826,18979,
"000","1993","25-29",46900,24822,22078,
"000","1993","30-34",59166,30374,28792,
"000","1993","35-39",61701,31858,29843,
"000","1993","40-44",54627,29180,25447,
"000","1993","45-49",39776,21563,18213,
"000","1993","50-54",27854,15250,12604,
"000","1993","55-59",18891,10191,8700,
"000","1993","60-64",14249,7436,6813,
"000","1993","65-69",10954,5560,5394,
"000","1993","70-74",7836,3752,4084,
"000","1993","75-79",4590,2110,2480,
"000","1993","80-84",2493,1024,1469,
"000","1993","85+",1702,600,1102,
"013","1993","0-4",133,62,71,
"013","1993","5-9",150,77,73,
"013","1993","10-14",142,75,67,
"013","1993","15-19",143,96,47,
"013","1993","20-24",192,145,47,
"013","1993","25-29",261,168,93,
"013","1993","30-34",300,211,89,
"013","1993","35-39",273,200,73,
"013","1993","40-44",215,122,93,
"013","1993","45-49",178,113,65,
"013","1993","50-54",125,63,62,
"013","1993","55-59",94,65,29,
"013","1993","60-64",61,43,18,
"013","1993","65-69",19,12,7,
"013","1993","70-74",18,13,5,
"013","1993","75-79",13,5,8,
"013","1993","80-84",0,0,0,
"013","1993","85+",0,0,0,
"016","1993","0-4",829,405,424,
"016","1993","5-9",522,322,200,
"016","1993","10-14",399,184,215,
"016","1993","15-19",718,468,250,
"016","1993","20-24",1693,1236,457,
"016","1993","25-29",1461,977,484,
"016","1993","30-34",1074,641,433,
"016","1993","35-39",1166,888,278,
"016","1993","40-44",605,392,213,
"016","1993","45-49",436,305,131,
"016","1993","50-54",238,174,64,
"016","1993","55-59",137,79,58,
"016","1993","60-64",60,43,17,
"016","1993","65-69",37,21,16,
"016","1993","70-74",21,14,7,
"016","1993","75-79",10,4,6,
"016","1993","80-84",14,10,4,
"016","1993","85+",2,0,2,
"020","1993","0-4",24048,12328,11720,
"020","1993","5-9",21655,11035,10620,
"020","1993","10-14",19902,10277,9625,
"020","1993","15-19",15707,8200,7507,
"020","1993","20-24",18694,9913,8781,
"020","1993","25-29",21022,10898,10124,
"020","1993","30-34",26149,13108,13041,
"020","1993","35-39",26084,13034,13050,
"020","1993","40-44",22814,11797,11017,
"020","1993","45-49",17181,8992,8189,
"020","1993","50-54",11843,6223,5620,
"020","1993","55-59",7980,4176,3804,
"020","1993","60-64",5845,2919,2926,
"020","1993","65-69",4332,2056,2276,
"020","1993","70-74",3085,1408,1677,
"020","1993","75-79",1628,720,908,
"020","1993","80-84",858,297,561,
"020","1993","85+",613,175,438,
"050","1993","0-4",1700,898,802,
"050","1993","5-9",1783,948,835,
"050","1993","10-14",1472,726,746,
"050","1993","15-19",1146,590,556,
"050","1993","20-24",997,476,521,
"050","1993","25-29",1271,698,573,
"050","1993","30-34",1320,724,596,
"050","1993","35-39",1177,638,539,
"050","1993","40-44",968,532,436,
"050","1993","45-49",692,396,296,
"050","1993","50-54",551,272,279,
"050","1993","55-59",423,224,199,
"050","1993","60-64",340,175,165,
"050","1993","65-69",240,129,111,
"050","1993","70-74",186,91,95,
"050","1993","75-79",161,74,87,
"050","1993","80-84",78,44,34,
"050","1993","85+",52,33,19,
"060","1993","0-4",103,58,45,
"060","1993","5-9",141,68,73,
"060","1993","10-14",116,45,71,
"060","1993","15-19",92,49,43,
"060","1993","20-24",108,64,44,
"060","1993","25-29",171,129,42,
"060","1993","30-34",224,138,86,
"060","1993","35-39",187,121,66,
"060","1993","40-44",148,76,72,
"060","1993","45-49",86,53,33,
"060","1993","50-54",72,48,24,
"060","1993","55-59",41,27,14,
"060","1993","60-64",29,19,10,
"060","1993","65-69",23,10,13,
"060","1993","70-74",12,5,7,
"060","1993","75-79",15,8,7,
"060","1993","80-84",1,1,0,
"060","1993","85+",4,1,3,
"068","1993","0-4",113,65,48,
"068","1993","5-9",131,67,64,
"068","1993","10-14",175,96,79,
"068","1993","15-19",103,57,46,
"068","1993","20-24",79,51,28,
"068","1993","25-29",113,63,50,
"068","1993","30-34",200,118,82,
"068","1993","35-39",198,103,95,
"068","1993","40-44",223,135,88,
"068","1993","45-49",160,97,63,
"068","1993","50-54",143,104,39,
"068","1993","55-59",72,42,30,
"068","1993","60-64",34,25,9,
"068","1993","65-69",19,12,7,
"068","1993","70-74",16,12,4,
"068","1993","75-79",6,2,4,
"068","1993","80-84",5,4,1,
"068","1993","85+",3,1,2,
"070","1993","0-4",603,310,293,
"070","1993","5-9",527,271,256,
"070","1993","10-14",393,206,187,
"070","1993","15-19",287,148,139,
"070","1993","20-24",224,112,112,
"070","1993","25-29",327,146,181,
"070","1993","30-34",420,214,206,
"070","1993","35-39",417,233,184,
"070","1993","40-44",334,182,152,
"070","1993","45-49",195,105,90,
"070","1993","50-54",197,94,103,
"070","1993","55-59",120,64,56,
"070","1993","60-64",113,63,50,
"070","1993","65-69",74,35,39,
"070","1993","70-74",54,27,27,
"070","1993","75-79",30,12,18,
"070","1993","80-84",25,12,13,
"070","1993","85+",21,9,12,
"090","1993","0-4",8474,4232,4242,
"090","1993","5-9",7398,3842,3556,
"090","1993","10-14",6673,3472,3201,
"090","1993","15-19",5692,3053,2639,
"090","1993","20-24",7677,4533,3144,
"090","1993","25-29",6959,3722,3237,
"090","1993","30-34",8086,4176,3910,
"090","1993","35-39",7999,4011,3988,
"090","1993","40-44",7090,3911,3179,
"090","1993","45-49",4925,2673,2252,
"090","1993","50-54",3412,1874,1538,
"090","1993","55-59",2227,1217,1010,
"090","1993","60-64",1701,899,802,
"090","1993","65-69",1260,658,602,
"090","1993","70-74",865,396,469,
"090","1993","75-79",556,271,285,
"090","1993","80-84",293,127,166,
"090","1993","85+",185,63,122,
"100","1993","0-4",163,76,87,
"100","1993","5-9",175,83,92,
"100","1993","10-14",217,107,110,
"100","1993","15-19",163,85,78,
"100","1993","20-24",87,46,41,
"100","1993","25-29",125,60,65,
"100","1993","30-34",183,96,87,
"100","1993","35-39",249,122,127,
"100","1993","40-44",241,127,114,
"100","1993","45-49",189,99,90,
"100","1993","50-54",126,65,61,
"100","1993","55-59",94,57,37,
"100","1993","60-64",76,34,42,
"100","1993","65-69",67,40,27,
"100","1993","70-74",71,37,34,
"100","1993","75-79",45,20,25,
"100","1993","80-84",18,8,10,
"100","1993","85+",4,0,4,
"110","1993","0-4",2448,1230,1218,
"110","1993","5-9",2522,1282,1240,
"110","1993","10-14",2283,1176,1107,
"110","1993","15-19",1733,889,844,
"110","1993","20-24",1501,719,782,
"110","1993","25-29",1951,981,970,
"110","1993","30-34",2796,1345,1451,
"110","1993","35-39",3076,1524,1552,
"110","1993","40-44",3103,1566,1537,
"110","1993","45-49",2267,1202,1065,
"110","1993","50-54",1532,827,705,
"110","1993","55-59",969,517,452,
"110","1993","60-64",677,345,332,
"110","1993","65-69",554,268,286,
"110","1993","70-74",438,185,253,
"110","1993","75-79",318,133,185,
"110","1993","80-84",175,74,101,
"110","1993","85+",105,36,69,
"122","1993","0-4",3831,2007,1824,
"122","1993","5-9",4066,2095,1971,
"122","1993","10-14",4239,2195,2044,
"122","1993","15-19",3167,1749,1418,
"122","1993","20-24",2165,1152,1013,
"122","1993","25-29",2578,1350,1228,
"122","1993","30-34",3767,1926,1841,
"122","1993","35-39",4765,2432,2333,
"122","1993","40-44",4540,2451,2089,
"122","1993","45-49",3221,1825,1396,
"122","1993","50-54",2172,1187,985,
"122","1993","55-59",1496,797,699,
"122","1993","60-64",1251,650,601,
"122","1993","65-69",1068,576,492,
"122","1993","70-74",764,394,370,
"122","1993","75-79",391,193,198,
"122","1993","80-84",209,100,109,
"122","1993","85+",124,45,79,
"130","1993","0-4",1255,643,612,
"130","1993","5-9",1227,650,577,
"130","1993","10-14",1240,637,603,
"130","1993","15-19",964,513,451,
"130","1993","20-24",844,443,401,
"130","1993","25-29",1022,520,502,
"130","1993","30-34",1335,705,630,
"130","1993","35-39",1471,792,679,
"130","1993","40-44",1379,702,677,
"130","1993","45-49",1094,579,515,
"130","1993","50-54",860,485,375,
"130","1993","55-59",558,312,246,
"130","1993","60-64",425,232,193,
"130","1993","65-69",379,199,180,
"130","1993","70-74",276,124,152,
"130","1993","75-79",200,92,108,
"130","1993","80-84",98,40,58,
"130","1993","85+",89,35,54,
"150","1993","0-4",1600,815,785,
"150","1993","5-9",1320,663,657,
"150","1993","10-14",1259,652,607,
"150","1993","15-19",975,535,440,
"150","1993","20-24",979,568,411,
"150","1993","25-29",1248,703,545,
"150","1993","30-34",1604,918,686,
"150","1993","35-39",1587,875,712,
"150","1993","40-44",1328,751,577,
"150","1993","45-49",951,541,410,
"150","1993","50-54",552,315,237,
"150","1993","55-59",360,200,160,
"150","1993","60-64",298,171,127,
"150","1993","65-69",212,106,106,
"150","1993","70-74",158,98,60,
"150","1993","75-79",87,41,46,
"150","1993","80-84",43,16,27,
"150","1993","85+",33,9,24,
"164","1993","0-4",227,112,115,
"164","1993","5-9",215,109,106,
"164","1993","10-14",201,115,86,
"164","1993","15-19",116,55,61,
"164","1993","20-24",66,35,31,
"164","1993","25-29",159,79,80,
"164","1993","30-34",188,115,73,
"164","1993","35-39",168,90,78,
"164","1993","40-44",127,69,58,
"164","1993","45-49",78,52,26,
"164","1993","50-54",66,33,33,
"164","1993","55-59",55,33,22,
"164","1993","60-64",47,27,20,
"164","1993","65-69",40,22,18,
"164","1993","70-74",23,12,11,
"164","1993","75-79",14,6,8,
"164","1993","80-84",14,7,7,
"164","1993","85+",3,2,1,
"170","1993","0-4",4071,2114,1957,
"170","1993","5-9",4886,2471,2415,
"170","1993","10-14",5083,2676,2407,
"170","1993","15-19",3372,1753,1619,
"170","1993","20-24",1897,935,962,
"170","1993","25-29",2469,1203,1266,
"170","1993","30-34",4360,2123,2237,
"170","1993","35-39",5327,2731,2596,
"170","1993","40-44",4808,2572,2236,
"170","1993","45-49",3075,1693,1382,
"170","1993","50-54",2208,1287,921,
"170","1993","55-59",1436,777,659,
"170","1993","60-64",1245,682,563,
"170","1993","65-69",1036,556,480,
"170","1993","70-74",674,347,327,
"170","1993","75-79",391,181,210,
"170","1993","80-84",194,83,111,
"170","1993","85+",127,51,76,
"180","1993","0-4",955,499,456,
"180","1993","5-9",996,511,485,
"180","1993","10-14",867,434,433,
"180","1993","15-19",714,377,337,
"180","1993","20-24",567,296,271,
"180","1993","25-29",692,390,302,
"180","1993","30-34",815,452,363,
"180","1993","35-39",751,405,346,
"180","1993","40-44",673,397,276,
"180","1993","45-49",513,285,228,
"180","1993","50-54",331,183,148,
"180","1993","55-59",299,167,132,
"180","1993","60-64",222,116,106,
"180","1993","65-69",165,87,78,
"180","1993","70-74",120,63,57,
"180","1993","75-79",92,39,53,
"180","1993","80-84",67,27,40,
"180","1993","85+",26,13,13,
"185","1993","0-4",874,454,420,
"185","1993","5-9",775,389,386,
"185","1993","10-14",659,344,315,
"185","1993","15-19",421,200,221,
"185","1993","20-24",371,190,181,
"185","1993","25-29",575,305,270,
"185","1993","30-34",632,322,310,
"185","1993","35-39",558,335,223,
"185","1993","40-44",510,304,206,
"185","1993","45-49",397,235,162,
"185","1993","50-54",289,164,125,
"185","1993","55-59",210,112,98,
"185","1993","60-64",144,88,56,
"185","1993","65-69",84,49,35,
"185","1993","70-74",60,28,32,
"185","1993","75-79",40,17,23,
"185","1993","80-84",37,12,25,
"185","1993","85+",12,4,8,
"188","1993","0-4",938,519,419,
"188","1993","5-9",839,443,396,
"188","1993","10-14",694,356,338,
"188","1993","15-19",501,273,228,
"188","1993","20-24",463,232,231,
"188","1993","25-29",566,320,246,
"188","1993","30-34",556,312,244,
"188","1993","35-39",477,250,227,
"188","1993","40-44",359,225,134,
"188","1993","45-49",292,146,146,
"188","1993","50-54",210,131,79,
"188","1993","55-59",170,90,80,
"188","1993","60-64",180,95,85,
"188","1993","65-69",116,57,59,
"188","1993","70-74",80,36,44,
"188","1993","75-79",47,21,26,
"188","1993","80-84",24,9,15,
"188","1993","85+",33,13,20,
"201","1993","0-4",615,334,281,
"201","1993","5-9",641,289,352,
"201","1993","10-14",655,361,294,
"201","1993","15-19",437,242,195,
"201","1993","20-24",386,197,189,
"201","1993","25-29",464,245,219,
"201","1993","30-34",653,353,300,
"201","1993","35-39",668,379,289,
"201","1993","40-44",655,368,287,
"201","1993","45-49",490,308,182,
"201","1993","50-54",417,240,177,
"201","1993","55-59",261,172,89,
"201","1993","60-64",169,97,72,
"201","1993","65-69",125,71,54,
"201","1993","70-74",88,49,39,
"201","1993","75-79",28,18,10,
"201","1993","80-84",24,11,13,
"201","1993","85+",21,10,11,
"220","1993","0-4",782,418,364,
"220","1993","5-9",763,357,406,
"220","1993","10-14",847,478,369,
"220","1993","15-19",614,355,259,
"220","1993","20-24",589,311,278,
"220","1993","25-29",655,352,303,
"220","1993","30-34",837,441,396,
"220","1993","35-39",935,458,477,
"220","1993","40-44",826,454,372,
"220","1993","45-49",560,288,272,
"220","1993","50-54",446,263,183,
"220","1993","55-59",384,202,182,
"220","1993","60-64",253,132,121,
"220","1993","65-69",190,86,104,
"220","1993","70-74",153,63,90,
"220","1993","75-79",103,54,49,
"220","1993","80-84",77,33,44,
"220","1993","85+",69,14,55,
"232","1993","0-4",290,160,130,
"232","1993","5-9",362,179,183,
"232","1993","10-14",398,216,182,
"232","1993","15-19",288,136,152,
"232","1993","20-24",164,95,69,
"232","1993","25-29",212,113,99,
"232","1993","30-34",368,211,157,
"232","1993","35-39",388,221,167,
"232","1993","40-44",388,201,187,
"232","1993","45-49",286,163,123,
"232","1993","50-54",211,122,89,
"232","1993","55-59",168,105,63,
"232","1993","60-64",102,60,42,
"232","1993","65-69",78,39,39,
"232","1993","70-74",84,49,35,
"232","1993","75-79",32,9,23,
"232","1993","80-84",19,7,12,
"232","1993","85+",16,8,8,
"240","1993","0-4",483,221,262,
"240","1993","5-9",614,341,273,
"240","1993","10-14",746,387,359,
"240","1993","15-19",504,302,202,
"240","1993","20-24",351,196,155,
"240","1993","25-29",340,168,172,
"240","1993","30-34",524,264,260,
"240","1993","35-39",679,321,358,
"240","1993","40-44",587,325,262,
"240","1993","45-49",395,219,176,
"240","1993","50-54",379,228,151,
"240","1993","55-59",221,108,113,
"240","1993","60-64",147,87,60,
"240","1993","65-69",142,90,52,
"240","1993","70-74",79,37,42,
"240","1993","75-79",47,20,27,
"240","1993","80-84",23,12,11,
"240","1993","85+",19,7,12,
"261","1993","0-4",808,367,441,
"261","1993","5-9",980,506,474,
"261","1993","10-14",883,452,431,
"261","1993","15-19",655,350,305,
"261","1993","20-24",533,284,249,
"261","1993","25-29",680,365,315,
"261","1993","30-34",956,503,453,
"261","1993","35-39",1223,662,561,
"261","1993","40-44",1075,594,481,
"261","1993","45-49",847,481,366,
"261","1993","50-54",599,351,248,
"261","1993","55-59",373,231,142,
"261","1993","60-64",258,149,109,
"261","1993","65-69",204,113,91,
"261","1993","70-74",159,76,83,
"261","1993","75-79",85,43,42,
"261","1993","80-84",46,25,21,
"261","1993","85+",39,20,19,
"270","1993","0-4",858,456,402,
"270","1993","5-9",945,483,462,
"270","1993","10-14",675,342,333,
"270","1993","15-19",576,274,302,
"270","1993","20-24",496,229,267,
"270","1993","25-29",562,297,265,
"270","1993","30-34",502,270,232,
"270","1993","35-39",399,232,167,
"270","1993","40-44",314,165,149,
"270","1993","45-49",268,152,116,
"270","1993","50-54",183,111,72,
"270","1993","55-59",223,111,112,
"270","1993","60-64",150,69,81,
"270","1993","65-69",131,71,60,
"270","1993","70-74",81,39,42,
"270","1993","75-79",44,28,16,
"270","1993","80-84",34,11,23,
"270","1993","85+",23,15,8,
"280","1993","0-4",598,313,285,
"280","1993","5-9",697,357,340,
"280","1993","10-14",610,331,279,
"280","1993","15-19",446,217,229,
"280","1993","20-24",337,181,156,
"280","1993","25-29",466,249,217,
"280","1993","30-34",683,346,337,
"280","1993","35-39",774,396,378,
"280","1993","40-44",691,400,291,
"280","1993","45-49",541,293,248,
"280","1993","50-54",379,230,149,
"280","1993","55-59",258,147,111,
"280","1993","60-64",234,121,113,
"280","1993","65-69",178,89,89,
"280","1993","70-74",167,96,71,
"280","1993","75-79",126,53,73,
"280","1993","80-84",65,28,37,
"280","1993","85+",40,16,24,
"282","1993","0-4",61,33,28,
"282","1993","5-9",66,30,36,
"282","1993","10-14",58,39,19,
"282","1993","15-19",36,20,16,
"282","1993","20-24",43,23,20,
"282","1993","25-29",55,23,32,
"282","1993","30-34",57,37,20,
"282","1993","35-39",75,37,38,
"282","1993","40-44",71,48,23,
"282","1993","45-49",59,33,26,
"282","1993","50-54",34,25,9,
"282","1993","55-59",26,13,13,
"282","1993","60-64",16,6,10,
"282","1993","65-69",31,20,11,
"282","1993","70-74",7,4,3,
"282","1993","75-79",5,2,3,
"282","1993","80-84",4,2,2,
"282","1993","85+",3,0,3,
"290","1993","0-4",634,335,299,
"290","1993","5-9",772,408,364,
"290","1993","10-14",724,388,336,
"290","1993","15-19",520,312,208,
"290","1993","20-24",302,164,138,
"290","1993","25-29",496,298,198,
"290","1993","30-34",577,305,272,
"290","1993","35-39",630,368,262,
"290","1993","40-44",555,314,241,
"290","1993","45-49",400,235,165,
"290","1993","50-54",279,151,128,
"290","1993","55-59",236,146,90,
"290","1993","60-64",172,89,83,
"290","1993","65-69",150,88,62,
"290","1993","70-74",97,49,48,
"290","1993","75-79",76,44,32,
"290","1993","80-84",48,24,24,
"290","1993","85+",36,20,16,
"000","1994","0-4",55110,28102,27008,
"000","1994","5-9",55608,28559,27049,
"000","1994","10-14",53287,27495,25792,
"000","1994","15-19",41143,21961,19182,
"000","1994","20-24",40808,22090,18718,
"000","1994","25-29",45666,23951,21715,
"000","1994","30-34",57986,29912,28074,
"000","1994","35-39",61063,31352,29711,
"000","1994","40-44",55936,29562,26374,
"000","1994","45-49",42083,22683,19400,
"000","1994","50-54",29509,16086,13423,
"000","1994","55-59",19389,10464,8925,
"000","1994","60-64",14392,7494,6898,
"000","1994","65-69",11149,5687,5462,
"000","1994","70-74",8245,3921,4324,
"000","1994","75-79",4743,2182,2561,
"000","1994","80-84",2682,1126,1556,
"000","1994","85+",1823,612,1211,
"013","1994","0-4",127,61,66,
"013","1994","5-9",148,69,79,
"013","1994","10-14",146,82,64,
"013","1994","15-19",123,75,48,
"013","1994","20-24",222,173,49,
"013","1994","25-29",245,159,86,
"013","1994","30-34",318,225,93,
"013","1994","35-39",249,172,77,
"013","1994","40-44",212,125,87,
"013","1994","45-49",169,114,55,
"013","1994","50-54",138,69,69,
"013","1994","55-59",104,67,37,
"013","1994","60-64",48,38,10,
"013","1994","65-69",27,17,10,
"013","1994","70-74",19,14,5,
"013","1994","75-79",11,5,6,
"013","1994","80-84",0,0,0,
"013","1994","85+",0,0,0,
"016","1994","0-4",347,192,155,
"016","1994","5-9",305,172,133,
"016","1994","10-14",328,167,161,
"016","1994","15-19",234,134,100,
"016","1994","20-24",394,239,155,
"016","1994","25-29",694,440,254,
"016","1994","30-34",938,691,247,
"016","1994","35-39",845,607,238,
"016","1994","40-44",586,372,214,
"016","1994","45-49",539,376,163,
"016","1994","50-54",269,179,90,
"016","1994","55-59",184,117,67,
"016","1994","60-64",118,72,46,
"016","1994","65-69",58,34,24,
"016","1994","70-74",30,17,13,
"016","1994","75-79",20,11,9,
"016","1994","80-84",10,4,6,
"016","1994","85+",4,2,2,
"020","1994","0-4",23218,11823,11395,
"020","1994","5-9",22190,11351,10839,
"020","1994","10-14",20595,10616,9979,
"020","1994","15-19",16427,8588,7839,
"020","1994","20-24",18659,9896,8763,
"020","1994","25-29",21087,10943,10144,
"020","1994","30-34",25798,12976,12822,
"020","1994","35-39",26379,13198,13181,
"020","1994","40-44",23292,11970,11322,
"020","1994","45-49",18074,9350,8724,
"020","1994","50-54",12515,6581,5934,
"020","1994","55-59",8272,4318,3954,
"020","1994","60-64",5863,2905,2958,
"020","1994","65-69",4414,2131,2283,
"020","1994","70-74",3346,1498,1848,
"020","1994","75-79",1751,771,980,
"020","1994","80-84",959,368,591,
"020","1994","85+",664,181,483,
"050","1994","0-4",1677,860,817,
"050","1994","5-9",1809,964,845,
"050","1994","10-14",1581,781,800,
"050","1994","15-19",1188,627,561,
"050","1994","20-24",1053,523,530,
"050","1994","25-29",1236,658,578,
"050","1994","30-34",1367,749,618,
"050","1994","35-39",1211,646,565,
"050","1994","40-44",1010,557,453,
"050","1994","45-49",728,428,300,
"050","1994","50-54",627,319,308,
"050","1994","55-59",381,209,172,
"050","1994","60-64",356,173,183,
"050","1994","65-69",243,133,110,
"050","1994","70-74",185,93,92,
"050","1994","75-79",150,72,78,
"050","1994","80-84",88,44,44,
"050","1994","85+",43,24,19,
"060","1994","0-4",100,57,43,
"060","1994","5-9",144,72,72,
"060","1994","10-14",119,60,59,
"060","1994","15-19",93,42,51,
"060","1994","20-24",51,31,20,
"060","1994","25-29",54,31,23,
"060","1994","30-34",141,72,69,
"060","1994","35-39",146,82,64,
"060","1994","40-44",137,68,69,
"060","1994","45-49",89,54,35,
"060","1994","50-54",89,60,29,
"060","1994","55-59",44,22,22,
"060","1994","60-64",35,24,11,
"060","1994","65-69",22,14,8,
"060","1994","70-74",12,6,6,
"060","1994","75-79",5,3,2,
"060","1994","80-84",3,2,1,
"060","1994","85+",1,0,1,
"068","1994","0-4",129,78,51,
"068","1994","5-9",135,72,63,
"068","1994","10-14",165,87,78,
"068","1994","15-19",116,64,52,
"068","1994","20-24",81,49,32,
"068","1994","25-29",103,65,38,
"068","1994","30-34",202,106,96,
"068","1994","35-39",201,119,82,
"068","1994","40-44",232,137,95,
"068","1994","45-49",166,98,68,
"068","1994","50-54",145,107,38,
"068","1994","55-59",72,41,31,
"068","1994","60-64",41,29,12,
"068","1994","65-69",20,13,7,
"068","1994","70-74",14,9,5,
"068","1994","75-79",6,2,4,
"068","1994","80-84",4,4,0,
"068","1994","85+",1,1,0,
"070","1994","0-4",522,279,243,
"070","1994","5-9",507,263,244,
"070","1994","10-14",411,211,200,
"070","1994","15-19",289,154,135,
"070","1994","20-24",230,123,107,
"070","1994","25-29",305,139,166,
"070","1994","30-34",418,220,198,
"070","1994","35-39",425,234,191,
"070","1994","40-44",325,180,145,
"070","1994","45-49",213,115,98,
"070","1994","50-54",201,101,100,
"070","1994","55-59",119,64,55,
"070","1994","60-64",109,57,52,
"070","1994","65-69",83,39,44,
"070","1994","70-74",57,30,27,
"070","1994","75-79",33,14,19,
"070","1994","80-84",28,13,15,
"070","1994","85+",27,12,15,
"090","1994","0-4",7832,3917,3915,
"090","1994","5-9",7536,3860,3676,
"090","1994","10-14",6942,3598,3344,
"090","1994","15-19",5846,3171,2675,
"090","1994","20-24",7742,4578,3164,
"090","1994","25-29",7058,3712,3346,
"090","1994","30-34",8033,4156,3877,
"090","1994","35-39",7930,4008,3922,
"090","1994","40-44",7102,3793,3309,
"090","1994","45-49",5185,2826,2359,
"090","1994","50-54",3540,1939,1601,
"090","1994","55-59",2201,1202,999,
"090","1994","60-64",1688,872,816,
"090","1994","65-69",1238,662,576,
"090","1994","70-74",877,389,488,
"090","1994","75-79",582,288,294,
"090","1994","80-84",290,134,156,
"090","1994","85+",196,61,135,
"100","1994","0-4",170,79,91,
"100","1994","5-9",169,87,82,
"100","1994","10-14",220,108,112,
"100","1994","15-19",169,85,84,
"100","1994","20-24",89,51,38,
"100","1994","25-29",104,48,56,
"100","1994","30-34",189,93,96,
"100","1994","35-39",219,107,112,
"100","1994","40-44",244,123,121,
"100","1994","45-49",219,122,97,
"100","1994","50-54",143,74,69,
"100","1994","55-59",100,60,40,
"100","1994","60-64",84,37,47,
"100","1994","65-69",67,37,30,
"100","1994","70-74",73,41,32,
"100","1994","75-79",44,17,27,
"100","1994","80-84",24,11,13,
"100","1994","85+",4,0,4,
"110","1994","0-4",2358,1188,1170,
"110","1994","5-9",2421,1237,1184,
"110","1994","10-14",2394,1229,1165,
"110","1994","15-19",1763,924,839,
"110","1994","20-24",1454,695,759,
"110","1994","25-29",1990,1028,962,
"110","1994","30-34",2619,1267,1352,
"110","1994","35-39",2997,1494,1503,
"110","1994","40-44",3082,1530,1552,
"110","1994","45-49",2434,1254,1180,
"110","1994","50-54",1640,893,747,
"110","1994","55-59",995,523,472,
"110","1994","60-64",662,352,310,
"110","1994","65-69",594,284,310,
"110","1994","70-74",435,192,243,
"110","1994","75-79",327,136,191,
"110","1994","80-84",182,72,110,
"110","1994","85+",107,38,69,
"122","1994","0-4",3851,2017,1834,
"122","1994","5-9",4135,2086,2049,
"122","1994","10-14",4491,2286,2205,
"122","1994","15-19",3291,1836,1455,
"122","1994","20-24",2245,1210,1035,
"122","1994","25-29",2542,1350,1192,
"122","1994","30-34",3683,1855,1828,
"122","1994","35-39",4660,2392,2268,
"122","1994","40-44",4817,2588,2229,
"122","1994","45-49",3479,1919,1560,
"122","1994","50-54",2364,1310,1054,
"122","1994","55-59",1542,805,737,
"122","1994","60-64",1262,678,584,
"122","1994","65-69",1099,580,519,
"122","1994","70-74",816,415,401,
"122","1994","75-79",425,200,225,
"122","1994","80-84",216,106,110,
"122","1994","85+",141,50,91,
"130","1994","0-4",1194,584,610,
"130","1994","5-9",1233,673,560,
"130","1994","10-14",1254,624,630,
"130","1994","15-19",987,547,440,
"130","1994","20-24",811,431,380,
"130","1994","25-29",989,492,497,
"130","1994","30-34",1323,707,616,
"130","1994","35-39",1457,772,685,
"130","1994","40-44",1402,723,679,
"130","1994","45-49",1130,593,537,
"130","1994","50-54",906,498,408,
"130","1994","55-59",597,335,262,
"130","1994","60-64",412,233,179,
"130","1994","65-69",378,194,184,
"130","1994","70-74",290,138,152,
"130","1994","75-79",191,87,104,
"130","1994","80-84",104,44,60,
"130","1994","85+",93,35,58,
"150","1994","0-4",1529,775,754,
"150","1994","5-9",1419,742,677,
"150","1994","10-14",1305,658,647,
"150","1994","15-19",1035,569,466,
"150","1994","20-24",1033,607,426,
"150","1994","25-29",1241,674,567,
"150","1994","30-34",1616,921,695,
"150","1994","35-39",1590,868,722,
"150","1994","40-44",1364,753,611,
"150","1994","45-49",1028,593,435,
"150","1994","50-54",627,350,277,
"150","1994","55-59",378,219,159,
"150","1994","60-64",316,177,139,
"150","1994","65-69",233,115,118,
"150","1994","70-74",168,98,70,
"150","1994","75-79",102,48,54,
"150","1994","80-84",45,22,23,
"150","1994","85+",30,9,21,
"164","1994","0-4",208,96,112,
"164","1994","5-9",222,113,109,
"164","1994","10-14",207,112,95,
"164","1994","15-19",124,60,64,
"164","1994","20-24",66,37,29,
"164","1994","25-29",137,68,69,
"164","1994","30-34",194,119,75,
"164","1994","35-39",159,86,73,
"164","1994","40-44",139,74,65,
"164","1994","45-49",74,52,22,
"164","1994","50-54",81,40,41,
"164","1994","55-59",60,36,24,
"164","1994","60-64",42,22,20,
"164","1994","65-69",42,24,18,
"164","1994","70-74",22,12,10,
"164","1994","75-79",15,6,9,
"164","1994","80-84",11,4,7,
"164","1994","85+",4,2,2,
"170","1994","0-4",4231,2181,2050,
"170","1994","5-9",4824,2475,2349,
"170","1994","10-14",5165,2728,2437,
"170","1994","15-19",3601,1920,1681,
"170","1994","20-24",2032,1012,1020,
"170","1994","25-29",2437,1201,1236,
"170","1994","30-34",4183,2011,2172,
"170","1994","35-39",5221,2642,2579,
"170","1994","40-44",5104,2679,2425,
"170","1994","45-49",3295,1820,1475,
"170","1994","50-54",2369,1358,1011,
"170","1994","55-59",1457,798,659,
"170","1994","60-64",1274,682,592,
"170","1994","65-69",1017,560,457,
"170","1994","70-74",684,348,336,
"170","1994","75-79",401,192,209,
"170","1994","80-84",197,78,119,
"170","1994","85+",144,54,90,
"180","1994","0-4",964,514,450,
"180","1994","5-9",1008,516,492,
"180","1994","10-14",876,431,445,
"180","1994","15-19",715,374,341,
"180","1994","20-24",587,308,279,
"180","1994","25-29",667,373,294,
"180","1994","30-34",764,428,336,
"180","1994","35-39",770,416,354,
"180","1994","40-44",678,395,283,
"180","1994","45-49",514,294,220,
"180","1994","50-54",353,198,155,
"180","1994","55-59",298,166,132,
"180","1994","60-64",214,113,101,
"180","1994","65-69",170,85,85,
"180","1994","70-74",123,69,54,
"180","1994","75-79",86,40,46,
"180","1994","80-84",73,31,42,
"180","1994","85+",35,16,19,
"185","1994","0-4",855,462,393,
"185","1994","5-9",799,398,401,
"185","1994","10-14",694,360,334,
"185","1994","15-19",452,237,215,
"185","1994","20-24",390,198,192,
"185","1994","25-29",544,292,252,
"185","1994","30-34",634,335,299,
"185","1994","35-39",584,340,244,
"185","1994","40-44",539,318,221,
"185","1994","45-49",409,252,157,
"185","1994","50-54",321,177,144,
"185","1994","55-59",218,116,102,
"185","1994","60-64",148,90,58,
"185","1994","65-69",90,44,46,
"185","1994","70-74",68,39,29,
"185","1994","75-79",43,19,24,
"185","1994","80-84",36,9,27,
"185","1994","85+",12,5,7,
"188","1994","0-4",841,441,400,
"188","1994","5-9",881,467,414,
"188","1994","10-14",726,372,354,
"188","1994","15-19",527,291,236,
"188","1994","20-24",461,218,243,
"188","1994","25-29",559,325,234,
"188","1994","30-34",588,333,255,
"188","1994","35-39",465,240,225,
"188","1994","40-44",387,241,146,
"188","1994","45-49",320,173,147,
"188","1994","50-54",192,109,83,
"188","1994","55-59",182,100,82,
"188","1994","60-64",167,85,82,
"188","1994","65-69",121,62,59,
"188","1994","70-74",85,39,46,
"188","1994","75-79",41,19,22,
"188","1994","80-84",35,13,22,
"188","1994","85+",31,12,19,
"201","1994","0-4",636,345,291,
"201","1994","5-9",596,276,320,
"201","1994","10-14",674,359,315,
"201","1994","15-19",451,260,191,
"201","1994","20-24",359,189,170,
"201","1994","25-29",445,236,209,
"201","1994","30-34",657,347,310,
"201","1994","35-39",640,362,278,
"201","1994","40-44",623,359,264,
"201","1994","45-49",530,325,205,
"201","1994","50-54",425,235,190,
"201","1994","55-59",271,179,92,
"201","1994","60-64",180,108,72,
"201","1994","65-69",130,75,55,
"201","1994","70-74",82,44,38,
"201","1994","75-79",30,15,15,
"201","1994","80-84",20,12,8,
"201","1994","85+",25,11,14,
"220","1994","0-4",772,396,376,
"220","1994","5-9",713,331,382,
"220","1994","10-14",808,446,362,
"220","1994","15-19",651,362,289,
"220","1994","20-24",577,306,271,
"220","1994","25-29",623,323,300,
"220","1994","30-34",800,435,365,
"220","1994","35-39",866,413,453,
"220","1994","40-44",851,461,390,
"220","1994","45-49",607,318,289,
"220","1994","50-54",433,252,181,
"220","1994","55-59",365,189,176,
"220","1994","60-64",272,145,127,
"220","1994","65-69",187,81,106,
"220","1994","70-74",173,73,100,
"220","1994","75-79",90,46,44,
"220","1994","80-84",80,36,44,
"220","1994","85+",73,13,60,
"232","1994","0-4",263,140,123,
"232","1994","5-9",339,177,162,
"232","1994","10-14",376,207,169,
"232","1994","15-19",287,134,153,
"232","1994","20-24",176,104,72,
"232","1994","25-29",207,111,96,
"232","1994","30-34",354,203,151,
"232","1994","35-39",380,223,157,
"232","1994","40-44",390,204,186,
"232","1994","45-49",318,173,145,
"232","1994","50-54",221,130,91,
"232","1994","55-59",173,101,72,
"232","1994","60-64",116,69,47,
"232","1994","65-69",76,39,37,
"232","1994","70-74",82,42,40,
"232","1994","75-79",27,8,19,
"232","1994","80-84",22,10,12,
"232","1994","85+",21,9,12,
"240","1994","0-4",426,184,242,
"240","1994","5-9",649,353,296,
"240","1994","10-14",722,380,342,
"240","1994","15-19",535,323,212,
"240","1994","20-24",367,196,171,
"240","1994","25-29",327,166,161,
"240","1994","30-34",531,263,268,
"240","1994","35-39",635,306,329,
"240","1994","40-44",608,325,283,
"240","1994","45-49",430,243,187,
"240","1994","50-54",372,219,153,
"240","1994","55-59",256,123,133,
"240","1994","60-64",147,90,57,
"240","1994","65-69",131,76,55,
"240","1994","70-74",88,45,43,
"240","1994","75-79",45,20,25,
"240","1994","80-84",25,13,12,
"240","1994","85+",20,9,11,
"261","1994","0-4",788,354,434,
"261","1994","5-9",966,517,449,
"261","1994","10-14",916,458,458,
"261","1994","15-19",682,373,309,
"261","1994","20-24",516,262,254,
"261","1994","25-29",620,327,293,
"261","1994","30-34",895,477,418,
"261","1994","35-39",1201,641,560,
"261","1994","40-44",1137,623,514,
"261","1994","45-49",871,500,371,
"261","1994","50-54",626,353,273,
"261","1994","55-59",411,255,156,
"261","1994","60-64",259,164,95,
"261","1994","65-69",200,110,90,
"261","1994","70-74",162,78,84,
"261","1994","75-79",78,38,40,
"261","1994","80-84",52,24,28,
"261","1994","85+",42,17,25,
"270","1994","0-4",854,444,410,
"270","1994","5-9",960,514,446,
"270","1994","10-14",752,366,386,
"270","1994","15-19",566,273,293,
"270","1994","20-24",499,243,256,
"270","1994","25-29",533,279,254,
"270","1994","30-34",511,272,239,
"270","1994","35-39",436,253,183,
"270","1994","40-44",320,164,156,
"270","1994","45-49",273,155,118,
"270","1994","50-54",204,123,81,
"270","1994","55-59",183,98,85,
"270","1994","60-64",164,74,90,
"270","1994","65-69",144,79,65,
"270","1994","70-74",77,37,40,
"270","1994","75-79",47,29,18,
"270","1994","80-84",37,11,26,
"270","1994","85+",22,13,9,
"280","1994","0-4",588,315,273,
"280","1994","5-9",676,344,332,
"280","1994","10-14",642,344,298,
"280","1994","15-19",430,207,223,
"280","1994","20-24",353,197,156,
"280","1994","25-29",446,239,207,
"280","1994","30-34",610,314,296,
"280","1994","35-39",734,361,373,
"280","1994","40-44",744,441,303,
"280","1994","45-49",527,277,250,
"280","1994","50-54",404,235,169,
"280","1994","55-59",269,162,107,
"280","1994","60-64",219,114,105,
"280","1994","65-69",184,90,94,
"280","1994","70-74",167,92,75,
"280","1994","75-79",128,60,68,
"280","1994","80-84",81,31,50,
"280","1994","85+",46,18,28,
"282","1994","0-4",54,27,27,
"282","1994","5-9",72,32,40,
"282","1994","10-14",66,39,27,
"282","1994","15-19",47,27,20,
"282","1994","20-24",32,19,13,
"282","1994","25-29",50,24,26,
"282","1994","30-34",71,39,32,
"282","1994","35-39",68,35,33,
"282","1994","40-44",81,57,24,
"282","1994","45-49",55,31,24,
"282","1994","50-54",37,26,11,
"282","1994","55-59",26,15,11,
"282","1994","60-64",20,10,10,
"282","1994","65-69",29,18,11,
"282","1994","70-74",9,5,4,
"282","1994","75-79",3,2,1,
"282","1994","80-84",4,2,2,
"282","1994","85+",3,0,3,
"290","1994","0-4",576,293,283,
"290","1994","5-9",752,398,354,
"290","1994","10-14",712,386,326,
"290","1994","15-19",514,304,210,
"290","1994","20-24",329,195,134,
"290","1994","25-29",423,248,175,
"290","1994","30-34",549,298,251,
"290","1994","35-39",595,335,260,
"290","1994","40-44",530,302,228,
"290","1994","45-49",407,228,179,
"290","1994","50-54",267,151,116,
"290","1994","55-59",231,144,87,
"290","1994","60-64",176,81,95,
"290","1994","65-69",152,91,61,
"290","1994","70-74",101,58,43,
"290","1994","75-79",62,34,28,
"290","1994","80-84",56,28,28,
"290","1994","85+",34,20,14,
"000","1995","0-4",52624,26774,25850,
"000","1995","5-9",55960,28775,27185,
"000","1995","10-14",54415,28007,26408,
"000","1995","15-19",42732,22730,20002,
"000","1995","20-24",38989,20906,18083,
"000","1995","25-29",44521,23190,21331,
"000","1995","30-34",55619,28599,27020,
"000","1995","35-39",60209,30935,29274,
"000","1995","40-44",56970,29729,27241,
"000","1995","45-49",44328,23893,20435,
"000","1995","50-54",30810,16602,14208,
"000","1995","55-59",20013,10846,9167,
"000","1995","60-64",14616,7572,7044,
"000","1995","65-69",11448,5842,5606,
"000","1995","70-74",8484,4041,4443,
"000","1995","75-79",5078,2306,2772,
"000","1995","80-84",2798,1152,1646,
"000","1995","85+",1967,670,1297,
"013","1995","0-4",120,63,57,
"013","1995","5-9",146,69,77,
"013","1995","10-14",135,73,62,
"013","1995","15-19",122,75,47,
"013","1995","20-24",198,149,49,
"013","1995","25-29",229,153,76,
"013","1995","30-34",274,188,86,
"013","1995","35-39",256,185,71,
"013","1995","40-44",209,122,87,
"013","1995","45-49",189,127,62,
"013","1995","50-54",147,79,68,
"013","1995","55-59",89,60,29,
"013","1995","60-64",59,39,20,
"013","1995","65-69",26,17,9,
"013","1995","70-74",21,16,5,
"013","1995","75-79",13,5,8,
"013","1995","80-84",1,1,0,
"013","1995","85+",0,0,0,
"016","1995","0-4",316,167,149,
"016","1995","5-9",296,152,144,
"016","1995","10-14",323,167,156,
"016","1995","15-19",210,120,90,
"016","1995","20-24",331,193,138,
"016","1995","25-29",701,460,241,
"016","1995","30-34",920,670,250,
"016","1995","35-39",736,520,216,
"016","1995","40-44",571,372,199,
"016","1995","45-49",558,407,151,
"016","1995","50-54",266,171,95,
"016","1995","55-59",160,95,65,
"016","1995","60-64",139,90,49,
"016","1995","65-69",64,29,35,
"016","1995","70-74",27,19,8,
"016","1995","75-79",18,10,8,
"016","1995","80-84",10,5,5,
"016","1995","85+",5,1,4,
"020","1995","0-4",22468,11372,11096,
"020","1995","5-9",22181,11409,10772,
"020","1995","10-14",21025,10791,10234,
"020","1995","15-19",16831,8734,8097,
"020","1995","20-24",17497,9196,8301,
"020","1995","25-29",20472,10613,9859,
"020","1995","30-34",24789,12421,12368,
"020","1995","35-39",25897,12999,12898,
"020","1995","40-44",23664,12069,11595,
"020","1995","45-49",18856,9742,9114,
"020","1995","50-54",13025,6786,6239,
"020","1995","55-59",8384,4361,4023,
"020","1995","60-64",6009,2998,3011,
"020","1995","65-69",4492,2185,2307,
"020","1995","70-74",3481,1546,1935,
"020","1995","75-79",1916,829,1087,
"020","1995","80-84",1023,371,652,
"020","1995","85+",719,204,515,
"050","1995","0-4",1671,872,799,
"050","1995","5-9",1901,1012,889,
"050","1995","10-14",1632,805,827,
"050","1995","15-19",1254,661,593,
"050","1995","20-24",1045,521,524,
"050","1995","25-29",1199,630,569,
"050","1995","30-34",1331,717,614,
"050","1995","35-39",1209,632,577,
"050","1995","40-44",1051,579,472,
"050","1995","45-49",780,452,328,
"050","1995","50-54",669,337,332,
"050","1995","55-59",377,203,174,
"050","1995","60-64",362,176,186,
"050","1995","65-69",264,149,115,
"050","1995","70-74",184,91,93,
"050","1995","75-79",145,70,75,
"050","1995","80-84",94,45,49,
"050","1995","85+",49,25,24,
"060","1995","0-4",81,40,41,
"060","1995","5-9",137,73,64,
"060","1995","10-14",116,62,54,
"060","1995","15-19",77,34,43,
"060","1995","20-24",51,31,20,
"060","1995","25-29",54,31,23,
"060","1995","30-34",129,68,61,
"060","1995","35-39",132,71,61,
"060","1995","40-44",136,74,62,
"060","1995","45-49",83,50,33,
"060","1995","50-54",82,51,31,
"060","1995","55-59",36,20,16,
"060","1995","60-64",29,16,13,
"060","1995","65-69",19,14,5,
"060","1995","70-74",16,9,7,
"060","1995","75-79",7,3,4,
"060","1995","80-84",3,2,1,
"060","1995","85+",1,0,1,
"068","1995","0-4",109,68,41,
"068","1995","5-9",139,77,62,
"068","1995","10-14",162,86,76,
"068","1995","15-19",125,74,51,
"068","1995","20-24",75,44,31,
"068","1995","25-29",107,61,46,
"068","1995","30-34",187,98,89,
"068","1995","35-39",221,122,99,
"068","1995","40-44",255,155,100,
"068","1995","45-49",155,92,63,
"068","1995","50-54",135,97,38,
"068","1995","55-59",76,44,32,
"068","1995","60-64",46,31,15,
"068","1995","65-69",19,11,8,
"068","1995","70-74",14,9,5,
"068","1995","75-79",4,1,3,
"068","1995","80-84",3,2,1,
"068","1995","85+",4,2,2,
"070","1995","0-4",524,284,240,
"070","1995","5-9",529,274,255,
"070","1995","10-14",437,224,213,
"070","1995","15-19",309,160,149,
"070","1995","20-24",203,110,93,
"070","1995","25-29",307,149,158,
"070","1995","30-34",419,221,198,
"070","1995","35-39",414,227,187,
"070","1995","40-44",348,186,162,
"070","1995","45-49",237,124,113,
"070","1995","50-54",200,100,100,
"070","1995","55-59",130,72,58,
"070","1995","60-64",102,51,51,
"070","1995","65-69",85,42,43,
"070","1995","70-74",61,31,30,
"070","1995","75-79",34,14,20,
"070","1995","80-84",21,11,10,
"070","1995","85+",29,14,15,
"090","1995","0-4",7369,3688,3681,
"090","1995","5-9",7565,3857,3708,
"090","1995","10-14",7060,3667,3393,
"090","1995","15-19",5976,3212,2764,
"090","1995","20-24",7402,4270,3132,
"090","1995","25-29",6982,3649,3333,
"090","1995","30-34",7703,4046,3657,
"090","1995","35-39",7760,3902,3858,
"090","1995","40-44",7192,3748,3444,
"090","1995","45-49",5479,2979,2500,
"090","1995","50-54",3712,2025,1687,
"090","1995","55-59",2349,1283,1066,
"090","1995","60-64",1682,869,813,
"090","1995","65-69",1282,678,604,
"090","1995","70-74",903,430,473,
"090","1995","75-79",618,290,328,
"090","1995","80-84",317,147,170,
"090","1995","85+",201,74,127,
"100","1995","0-4",146,69,77,
"100","1995","5-9",159,77,82,
"100","1995","10-14",216,111,105,
"100","1995","15-19",175,87,88,
"100","1995","20-24",87,46,41,
"100","1995","25-29",91,42,49,
"100","1995","30-34",180,89,91,
"100","1995","35-39",227,112,115,
"100","1995","40-44",235,121,114,
"100","1995","45-49",226,118,108,
"100","1995","50-54",152,78,74,
"100","1995","55-59",96,53,43,
"100","1995","60-64",85,40,45,
"100","1995","65-69",65,34,31,
"100","1995","70-74",68,38,30,
"100","1995","75-79",41,16,25,
"100","1995","80-84",26,13,13,
"100","1995","85+",5,2,3,
"110","1995","0-4",2156,1101,1055,
"110","1995","5-9",2459,1250,1209,
"110","1995","10-14",2452,1267,1185,
"110","1995","15-19",1877,967,910,
"110","1995","20-24",1482,723,759,
"110","1995","25-29",1938,988,950,
"110","1995","30-34",2565,1252,1313,
"110","1995","35-39",2961,1487,1474,
"110","1995","40-44",3114,1526,1588,
"110","1995","45-49",2596,1349,1247,
"110","1995","50-54",1714,921,793,
"110","1995","55-59",1025,546,479,
"110","1995","60-64",681,347,334,
"110","1995","65-69",601,299,302,
"110","1995","70-74",420,193,227,
"110","1995","75-79",346,144,202,
"110","1995","80-84",184,68,116,
"110","1995","85+",129,43,86,
"122","1995","0-4",3723,1937,1786,
"122","1995","5-9",4186,2126,2060,
"122","1995","10-14",4645,2372,2273,
"122","1995","15-19",3412,1899,1513,
"122","1995","20-24",2197,1178,1019,
"122","1995","25-29",2600,1366,1234,
"122","1995","30-34",3533,1772,1761,
"122","1995","35-39",4654,2433,2221,
"122","1995","40-44",4938,2585,2353,
"122","1995","45-49",3751,2072,1679,
"122","1995","50-54",2491,1357,1134,
"122","1995","55-59",1645,896,749,
"122","1995","60-64",1290,685,605,
"122","1995","65-69",1126,582,544,
"122","1995","70-74",866,438,428,
"122","1995","75-79",461,213,248,
"122","1995","80-84",227,112,115,
"122","1995","85+",161,55,106,
"130","1995","0-4",1136,579,557,
"130","1995","5-9",1275,689,586,
"130","1995","10-14",1260,628,632,
"130","1995","15-19",1052,578,474,
"130","1995","20-24",775,413,362,
"130","1995","25-29",991,489,502,
"130","1995","30-34",1242,658,584,
"130","1995","35-39",1430,744,686,
"130","1995","40-44",1429,734,695,
"130","1995","45-49",1134,594,540,
"130","1995","50-54",929,510,419,
"130","1995","55-59",621,351,270,
"130","1995","60-64",398,218,180,
"130","1995","65-69",395,198,197,
"130","1995","70-74",281,133,148,
"130","1995","75-79",204,96,108,
"130","1995","80-84",111,47,64,
"130","1995","85+",101,33,68,
"150","1995","0-4",1422,715,707,
"150","1995","5-9",1475,764,711,
"150","1995","10-14",1315,661,654,
"150","1995","15-19",1049,554,495,
"150","1995","20-24",941,572,369,
"150","1995","25-29",1185,634,551,
"150","1995","30-34",1541,842,699,
"150","1995","35-39",1570,887,683,
"150","1995","40-44",1362,745,617,
"150","1995","45-49",1050,591,459,
"150","1995","50-54",650,370,280,
"150","1995","55-59",372,205,167,
"150","1995","60-64",336,178,158,
"150","1995","65-69",239,127,112,
"150","1995","70-74",149,82,67,
"150","1995","75-79",108,58,50,
"150","1995","80-84",50,24,26,
"150","1995","85+",33,12,21,
"164","1995","0-4",186,83,103,
"164","1995","5-9",220,110,110,
"164","1995","10-14",216,110,106,
"164","1995","15-19",144,82,62,
"164","1995","20-24",76,35,41,
"164","1995","25-29",105,54,51,
"164","1995","30-34",168,97,71,
"164","1995","35-39",179,103,76,
"164","1995","40-44",148,76,72,
"164","1995","45-49",95,64,31,
"164","1995","50-54",81,43,38,
"164","1995","55-59",64,34,30,
"164","1995","60-64",42,27,15,
"164","1995","65-69",41,24,17,
"164","1995","70-74",23,12,11,
"164","1995","75-79",13,6,7,
"164","1995","80-84",10,2,8,
"164","1995","85+",5,2,3,
"170","1995","0-4",4064,2077,1987,
"170","1995","5-9",4794,2479,2315,
"170","1995","10-14",5359,2800,2559,
"170","1995","15-19",3931,2109,1822,
"170","1995","20-24",2086,1034,1052,
"170","1995","25-29",2433,1153,1280,
"170","1995","30-34",3980,1924,2056,
"170","1995","35-39",5298,2681,2617,
"170","1995","40-44",5357,2786,2571,
"170","1995","45-49",3615,1969,1646,
"170","1995","50-54",2514,1407,1107,
"170","1995","55-59",1605,905,700,
"170","1995","60-64",1290,671,619,
"170","1995","65-69",1054,584,470,
"170","1995","70-74",735,375,360,
"170","1995","75-79",429,211,218,
"170","1995","80-84",220,90,130,
"170","1995","85+",142,55,87,
"180","1995","0-4",893,475,418,
"180","1995","5-9",1027,522,505,
"180","1995","10-14",897,455,442,
"180","1995","15-19",735,397,338,
"180","1995","20-24",572,295,277,
"180","1995","25-29",646,352,294,
"180","1995","30-34",731,415,316,
"180","1995","35-39",799,417,382,
"180","1995","40-44",694,397,297,
"180","1995","45-49",514,310,204,
"180","1995","50-54",384,208,176,
"180","1995","55-59",277,158,119,
"180","1995","60-64",218,121,97,
"180","1995","65-69",187,93,94,
"180","1995","70-74",108,55,53,
"180","1995","75-79",100,50,50,
"180","1995","80-84",67,24,43,
"180","1995","85+",44,17,27,
"185","1995","0-4",793,426,367,
"185","1995","5-9",831,419,412,
"185","1995","10-14",740,373,367,
"185","1995","15-19",491,257,234,
"185","1995","20-24",395,190,205,
"185","1995","25-29",493,263,230,
"185","1995","30-34",627,329,298,
"185","1995","35-39",610,354,256,
"185","1995","40-44",552,307,245,
"185","1995","45-49",434,262,172,
"185","1995","50-54",312,170,142,
"185","1995","55-59",236,131,105,
"185","1995","60-64",148,83,65,
"185","1995","65-69",95,49,46,
"185","1995","70-74",71,36,35,
"185","1995","75-79",40,15,25,
"185","1995","80-84",37,9,28,
"185","1995","85+",15,6,9,
"188","1995","0-4",798,405,393,
"188","1995","5-9",909,481,428,
"188","1995","10-14",733,373,360,
"188","1995","15-19",545,296,249,
"188","1995","20-24",462,235,227,
"188","1995","25-29",506,293,213,
"188","1995","30-34",583,312,271,
"188","1995","35-39",453,235,218,
"188","1995","40-44",414,265,149,
"188","1995","45-49",320,181,139,
"188","1995","50-54",216,119,97,
"188","1995","55-59",182,102,80,
"188","1995","60-64",165,82,83,
"188","1995","65-69",122,58,64,
"188","1995","70-74",86,39,47,
"188","1995","75-79",37,19,18,
"188","1995","80-84",31,10,21,
"188","1995","85+",29,10,19,
"201","1995","0-4",593,330,263,
"201","1995","5-9",575,266,309,
"201","1995","10-14",670,361,309,
"201","1995","15-19",513,292,221,
"201","1995","20-24",354,194,160,
"201","1995","25-29",421,215,206,
"201","1995","30-34",612,325,287,
"201","1995","35-39",614,352,262,
"201","1995","40-44",628,351,277,
"201","1995","45-49",562,349,213,
"201","1995","50-54",428,233,195,
"201","1995","55-59",280,177,103,
"201","1995","60-64",185,118,67,
"201","1995","65-69",142,81,61,
"201","1995","70-74",88,51,37,
"201","1995","75-79",26,11,15,
"201","1995","80-84",23,10,13,
"201","1995","85+",20,10,10,
"220","1995","0-4",700,368,332,
"220","1995","5-9",739,346,393,
"220","1995","10-14",770,421,349,
"220","1995","15-19",655,364,291,
"220","1995","20-24",565,294,271,
"220","1995","25-29",595,323,272,
"220","1995","30-34",775,408,367,
"220","1995","35-39",867,410,457,
"220","1995","40-44",830,438,392,
"220","1995","45-49",615,329,286,
"220","1995","50-54",473,264,209,
"220","1995","55-59",376,198,178,
"220","1995","60-64",273,140,133,
"220","1995","65-69",201,94,107,
"220","1995","70-74",194,88,106,
"220","1995","75-79",90,41,49,
"220","1995","80-84",78,40,38,
"220","1995","85+",72,15,57,
"232","1995","0-4",234,117,117,
"232","1995","5-9",348,186,162,
"232","1995","10-14",374,206,168,
"232","1995","15-19",292,137,155,
"232","1995","20-24",175,96,79,
"232","1995","25-29",194,111,83,
"232","1995","30-34",294,158,136,
"232","1995","35-39",378,219,159,
"232","1995","40-44",383,202,181,
"232","1995","45-49",331,176,155,
"232","1995","50-54",225,130,95,
"232","1995","55-59",174,100,74,
"232","1995","60-64",118,74,44,
"232","1995","65-69",75,39,36,
"232","1995","70-74",74,33,41,
"232","1995","75-79",38,15,23,
"232","1995","80-84",22,10,12,
"232","1995","85+",18,6,12,
"240","1995","0-4",434,204,230,
"240","1995","5-9",603,297,306,
"240","1995","10-14",745,404,341,
"240","1995","15-19",612,359,253,
"240","1995","20-24",325,177,148,
"240","1995","25-29",329,169,160,
"240","1995","30-34",485,237,248,
"240","1995","35-39",621,294,327,
"240","1995","40-44",633,325,308,
"240","1995","45-49",476,271,205,
"240","1995","50-54",387,225,162,
"240","1995","55-59",288,149,139,
"240","1995","60-64",163,97,66,
"240","1995","65-69",123,66,57,
"240","1995","70-74",91,50,41,
"240","1995","75-79",44,18,26,
"240","1995","80-84",23,12,11,
"240","1995","85+",24,12,12,
"261","1995","0-4",741,344,397,
"261","1995","5-9",964,502,462,
"261","1995","10-14",945,468,477,
"261","1995","15-19",709,394,315,
"261","1995","20-24",485,254,231,
"261","1995","25-29",604,300,304,
"261","1995","30-34",861,459,402,
"261","1995","35-39",1138,599,539,
"261","1995","40-44",1169,632,537,
"261","1995","45-49",918,531,387,
"261","1995","50-54",648,370,278,
"261","1995","55-59",419,250,169,
"261","1995","60-64",252,153,99,
"261","1995","65-69",228,120,108,
"261","1995","70-74",150,73,77,
"261","1995","75-79",89,44,45,
"261","1995","80-84",47,22,25,
"261","1995","85+",49,23,26,
"270","1995","0-4",800,396,404,
"270","1995","5-9",1002,553,449,
"270","1995","10-14",776,378,398,
"270","1995","15-19",585,288,297,
"270","1995","20-24",499,246,253,
"270","1995","25-29",514,259,255,
"270","1995","30-34",492,256,236,
"270","1995","35-39",440,263,177,
"270","1995","40-44",331,169,162,
"270","1995","45-49",287,161,126,
"270","1995","50-54",224,132,92,
"270","1995","55-59",180,99,81,
"270","1995","60-64",164,78,86,
"270","1995","65-69",135,72,63,
"270","1995","70-74",89,40,49,
"270","1995","75-79",59,34,25,
"270","1995","80-84",33,12,21,
"270","1995","85+",22,12,10,
"280","1995","0-4",554,302,252,
"280","1995","5-9",680,357,323,
"280","1995","10-14",646,334,312,
"280","1995","15-19",446,232,214,
"280","1995","20-24",334,187,147,
"280","1995","25-29",400,206,194,
"280","1995","30-34",590,310,280,
"280","1995","35-39",730,356,374,
"280","1995","40-44",728,412,316,
"280","1995","45-49",562,306,256,
"280","1995","50-54",415,231,184,
"280","1995","55-59",291,171,120,
"280","1995","60-64",193,104,89,
"280","1995","65-69",186,94,92,
"280","1995","70-74",176,94,82,
"280","1995","75-79",133,59,74,
"280","1995","80-84",85,35,50,
"280","1995","85+",49,19,30,
"282","1995","0-4",63,31,32,
"282","1995","5-9",76,36,40,
"282","1995","10-14",71,42,29,
"282","1995","15-19",56,35,21,
"282","1995","20-24",29,13,16,
"282","1995","25-29",51,29,22,
"282","1995","30-34",74,32,42,
"282","1995","35-39",70,36,34,
"282","1995","40-44",88,63,25,
"282","1995","45-49",62,34,28,
"282","1995","50-54",37,25,12,
"282","1995","55-59",33,23,10,
"282","1995","60-64",15,8,7,
"282","1995","65-69",24,14,10,
"282","1995","70-74",11,5,6,
"282","1995","75-79",3,2,1,
"282","1995","80-84",3,2,1,
"282","1995","85+",4,0,4,
"290","1995","0-4",530,261,269,
"290","1995","5-9",744,392,352,
"290","1995","10-14",695,368,327,
"290","1995","15-19",549,333,216,
"290","1995","20-24",348,210,138,
"290","1995","25-29",374,198,176,
"290","1995","30-34",534,295,239,
"290","1995","35-39",545,295,250,
"290","1995","40-44",511,290,221,
"290","1995","45-49",443,253,190,
"290","1995","50-54",294,163,131,
"290","1995","55-59",248,160,88,
"290","1995","60-64",172,78,94,
"290","1995","65-69",158,89,69,
"290","1995","70-74",97,55,42,
"290","1995","75-79",62,32,30,
"290","1995","80-84",49,26,23,
"290","1995","85+",37,18,19,
"000","1996","0-4",50278,25602,24676,
"000","1996","5-9",56014,28804,27210,
"000","1996","10-14",55562,28610,26952,
"000","1996","15-19",44574,23671,20903,
"000","1996","20-24",37925,20289,17636,
"000","1996","25-29",43628,22625,21003,
"000","1996","30-34",52885,27194,25691,
"000","1996","35-39",59642,30538,29104,
"000","1996","40-44",57978,29917,28061,
"000","1996","45-49",47663,25626,22037,
"000","1996","50-54",31772,17036,14736,
"000","1996","55-59",21186,11431,9755,
"000","1996","60-64",15008,7813,7195,
"000","1996","65-69",11680,5925,5755,
"000","1996","70-74",8943,4310,4633,
"000","1996","75-79",5407,2456,2951,
"000","1996","80-84",2977,1218,1759,
"000","1996","85+",2090,708,1382,
"013","1996","0-4",109,53,56,
"013","1996","5-9",135,67,68,
"013","1996","10-14",128,71,57,
"013","1996","15-19",142,88,54,
"013","1996","20-24",204,156,48,
"013","1996","25-29",193,127,66,
"013","1996","30-34",271,186,85,
"013","1996","35-39",256,176,80,
"013","1996","40-44",201,139,62,
"013","1996","45-49",210,118,92,
"013","1996","50-54",161,99,62,
"013","1996","55-59",77,45,32,
"013","1996","60-64",52,38,14,
"013","1996","65-69",32,23,9,
"013","1996","70-74",17,12,5,
"013","1996","75-79",12,6,6,
"013","1996","80-84",4,3,1,
"013","1996","85+",1,0,1,
"016","1996","0-4",298,166,132,
"016","1996","5-9",295,148,147,
"016","1996","10-14",345,181,164,
"016","1996","15-19",220,117,103,
"016","1996","20-24",315,183,132,
"016","1996","25-29",672,465,207,
"016","1996","30-34",845,608,237,
"016","1996","35-39",748,511,237,
"016","1996","40-44",593,392,201,
"016","1996","45-49",632,440,192,
"016","1996","50-54",330,209,121,
"016","1996","55-59",155,97,58,
"016","1996","60-64",137,85,52,
"016","1996","65-69",55,22,33,
"016","1996","70-74",34,25,9,
"016","1996","75-79",20,9,11,
"016","1996","80-84",11,6,5,
"016","1996","85+",5,1,4,
"020","1996","0-4",21624,10969,10655,
"020","1996","5-9",22277,11444,10833,
"020","1996","10-14",21328,10857,10471,
"020","1996","15-19",17582,9207,8375,
"020","1996","20-24",16656,8665,7991,
"020","1996","25-29",20046,10330,9716,
"020","1996","30-34",23468,11792,11676,
"020","1996","35-39",25647,12855,12792,
"020","1996","40-44",24050,12072,11978,
"020","1996","45-49",19936,10328,9608,
"020","1996","50-54",13452,6957,6495,
"020","1996","55-59",8797,4552,4245,
"020","1996","60-64",6131,3056,3075,
"020","1996","65-69",4633,2248,2385,
"020","1996","70-74",3626,1631,1995,
"020","1996","75-79",2103,924,1179,
"020","1996","80-84",1086,415,671,
"020","1996","85+",792,223,569,
"050","1996","0-4",1621,833,788,
"050","1996","5-9",1893,1002,891,
"050","1996","10-14",1717,872,845,
"050","1996","15-19",1298,672,626,
"050","1996","20-24",1014,508,506,
"050","1996","25-29",1130,576,554,
"050","1996","30-34",1333,728,605,
"050","1996","35-39",1204,630,574,
"050","1996","40-44",1056,567,489,
"050","1996","45-49",837,477,360,
"050","1996","50-54",641,344,297,
"050","1996","55-59",423,216,207,
"050","1996","60-64",400,198,202,
"050","1996","65-69",255,140,115,
"050","1996","70-74",208,107,101,
"050","1996","75-79",131,64,67,
"050","1996","80-84",105,48,57,
"050","1996","85+",45,23,22,
"060","1996","0-4",84,44,40,
"060","1996","5-9",145,73,72,
"060","1996","10-14",135,74,61,
"060","1996","15-19",82,40,42,
"060","1996","20-24",46,27,19,
"060","1996","25-29",59,31,28,
"060","1996","30-34",105,57,48,
"060","1996","35-39",149,79,70,
"060","1996","40-44",135,72,63,
"060","1996","45-49",98,54,44,
"060","1996","50-54",78,47,31,
"060","1996","55-59",37,20,17,
"060","1996","60-64",31,17,14,
"060","1996","65-69",22,14,8,
"060","1996","70-74",12,7,5,
"060","1996","75-79",6,2,4,
"060","1996","80-84",4,3,1,
"060","1996","85+",2,1,1,
"068","1996","0-4",120,73,47,
"068","1996","5-9",139,83,56,
"068","1996","10-14",154,73,81,
"068","1996","15-19",124,74,50,
"068","1996","20-24",76,48,28,
"068","1996","25-29",113,64,49,
"068","1996","30-34",193,106,87,
"068","1996","35-39",235,127,108,
"068","1996","40-44",263,164,99,
"068","1996","45-49",189,110,79,
"068","1996","50-54",118,82,36,
"068","1996","55-59",90,56,34,
"068","1996","60-64",46,34,12,
"068","1996","65-69",18,9,9,
"068","1996","70-74",12,7,5,
"068","1996","75-79",9,5,4,
"068","1996","80-84",5,2,3,
"068","1996","85+",2,2,0,
"070","1996","0-4",515,280,235,
"070","1996","5-9",549,292,257,
"070","1996","10-14",455,224,231,
"070","1996","15-19",333,170,163,
"070","1996","20-24",195,111,84,
"070","1996","25-29",293,143,150,
"070","1996","30-34",408,211,197,
"070","1996","35-39",407,228,179,
"070","1996","40-44",374,192,182,
"070","1996","45-49",251,130,121,
"070","1996","50-54",208,115,93,
"070","1996","55-59",141,74,67,
"070","1996","60-64",113,53,60,
"070","1996","65-69",84,44,40,
"070","1996","70-74",70,34,36,
"070","1996","75-79",32,14,18,
"070","1996","80-84",19,8,11,
"070","1996","85+",29,14,15,
"090","1996","0-4",6957,3505,3452,
"090","1996","5-9",7407,3747,3660,
"090","1996","10-14",7143,3719,3424,
"090","1996","15-19",6242,3337,2905,
"090","1996","20-24",7432,4258,3174,
"090","1996","25-29",6765,3621,3144,
"090","1996","30-34",7406,3897,3509,
"090","1996","35-39",7613,3810,3803,
"090","1996","40-44",7318,3774,3544,
"090","1996","45-49",5987,3249,2738,
"090","1996","50-54",3851,2116,1735,
"090","1996","55-59",2536,1362,1174,
"090","1996","60-64",1727,917,810,
"090","1996","65-69",1350,713,637,
"090","1996","70-74",951,455,496,
"090","1996","75-79",631,283,348,
"090","1996","80-84",358,158,200,
"090","1996","85+",209,75,134,
"100","1996","0-4",139,63,76,
"100","1996","5-9",173,80,93,
"100","1996","10-14",227,115,112,
"100","1996","15-19",181,89,92,
"100","1996","20-24",93,48,45,
"100","1996","25-29",84,35,49,
"100","1996","30-34",183,98,85,
"100","1996","35-39",211,103,108,
"100","1996","40-44",249,129,120,
"100","1996","45-49",257,131,126,
"100","1996","50-54",143,75,68,
"100","1996","55-59",107,56,51,
"100","1996","60-64",84,40,44,
"100","1996","65-69",76,44,32,
"100","1996","70-74",67,39,28,
"100","1996","75-79",39,16,23,
"100","1996","80-84",29,14,15,
"100","1996","85+",10,4,6,
"110","1996","0-4",2104,1077,1027,
"110","1996","5-9",2405,1226,1179,
"110","1996","10-14",2519,1294,1225,
"110","1996","15-19",1967,1030,937,
"110","1996","20-24",1498,745,753,
"110","1996","25-29",1950,980,970,
"110","1996","30-34",2455,1194,1261,
"110","1996","35-39",3074,1558,1516,
"110","1996","40-44",3111,1508,1603,
"110","1996","45-49",2794,1461,1333,
"110","1996","50-54",1815,973,842,
"110","1996","55-59",1120,592,528,
"110","1996","60-64",710,363,347,
"110","1996","65-69",596,297,299,
"110","1996","70-74",429,195,234,
"110","1996","75-79",363,149,214,
"110","1996","80-84",193,73,120,
"110","1996","85+",127,45,82,
"122","1996","0-4",3512,1807,1705,
"122","1996","5-9",4259,2177,2082,
"122","1996","10-14",4711,2431,2280,
"122","1996","15-19",3611,1992,1619,
"122","1996","20-24",2072,1107,965,
"122","1996","25-29",2646,1364,1282,
"122","1996","30-34",3358,1682,1676,
"122","1996","35-39",4588,2356,2232,
"122","1996","40-44",5040,2605,2435,
"122","1996","45-49",4091,2251,1840,
"122","1996","50-54",2663,1420,1243,
"122","1996","55-59",1746,966,780,
"122","1996","60-64",1352,705,647,
"122","1996","65-69",1147,590,557,
"122","1996","70-74",910,469,441,
"122","1996","75-79",514,236,278,
"122","1996","80-84",258,121,137,
"122","1996","85+",176,61,115,
"130","1996","0-4",1066,535,531,
"130","1996","5-9",1272,672,600,
"130","1996","10-14",1261,640,621,
"130","1996","15-19",1056,567,489,
"130","1996","20-24",750,384,366,
"130","1996","25-29",993,502,491,
"130","1996","30-34",1197,621,576,
"130","1996","35-39",1367,716,651,
"130","1996","40-44",1405,711,694,
"130","1996","45-49",1231,650,581,
"130","1996","50-54",914,479,435,
"130","1996","55-59",646,369,277,
"130","1996","60-64",391,212,179,
"130","1996","65-69",402,199,203,
"130","1996","70-74",289,141,148,
"130","1996","75-79",190,87,103,
"130","1996","80-84",123,47,76,
"130","1996","85+",101,33,68,
"150","1996","0-4",1264,647,617,
"150","1996","5-9",1414,732,682,
"150","1996","10-14",1284,653,631,
"150","1996","15-19",1034,554,480,
"150","1996","20-24",874,502,372,
"150","1996","25-29",1039,538,501,
"150","1996","30-34",1375,729,646,
"150","1996","35-39",1504,851,653,
"150","1996","40-44",1327,716,611,
"150","1996","45-49",1083,604,479,
"150","1996","50-54",645,367,278,
"150","1996","55-59",406,224,182,
"150","1996","60-64",331,177,154,
"150","1996","65-69",240,129,111,
"150","1996","70-74",154,83,71,
"150","1996","75-79",100,55,45,
"150","1996","80-84",53,24,29,
"150","1996","85+",31,12,19,
"164","1996","0-4",181,85,96,
"164","1996","5-9",226,110,116,
"164","1996","10-14",215,108,107,
"164","1996","15-19",145,85,60,
"164","1996","20-24",80,39,41,
"164","1996","25-29",90,42,48,
"164","1996","30-34",163,87,76,
"164","1996","35-39",177,107,70,
"164","1996","40-44",158,78,80,
"164","1996","45-49",100,68,32,
"164","1996","50-54",81,45,36,
"164","1996","55-59",58,31,27,
"164","1996","60-64",42,22,20,
"164","1996","65-69",36,23,13,
"164","1996","70-74",27,19,8,
"164","1996","75-79",13,6,7,
"164","1996","80-84",12,4,8,
"164","1996","85+",6,2,4,
"170","1996","0-4",3998,2024,1974,
"170","1996","5-9",4823,2534,2289,
"170","1996","10-14",5583,2908,2675,
"170","1996","15-19",4205,2227,1978,
"170","1996","20-24",2094,1064,1030,
"170","1996","25-29",2553,1236,1317,
"170","1996","30-34",3804,1844,1960,
"170","1996","35-39",5318,2681,2637,
"170","1996","40-44",5528,2875,2653,
"170","1996","45-49",4043,2195,1848,
"170","1996","50-54",2626,1454,1172,
"170","1996","55-59",1757,988,769,
"170","1996","60-64",1292,680,612,
"170","1996","65-69",1119,601,518,
"170","1996","70-74",773,398,375,
"170","1996","75-79",468,223,245,
"170","1996","80-84",234,92,142,
"170","1996","85+",149,56,93,
"180","1996","0-4",840,451,389,
"180","1996","5-9",1075,534,541,
"180","1996","10-14",969,496,473,
"180","1996","15-19",756,403,353,
"180","1996","20-24",604,316,288,
"180","1996","25-29",609,324,285,
"180","1996","30-34",724,416,308,
"180","1996","35-39",810,431,379,
"180","1996","40-44",706,394,312,
"180","1996","45-49",567,350,217,
"180","1996","50-54",382,207,175,
"180","1996","55-59",293,163,130,
"180","1996","60-64",225,131,94,
"180","1996","65-69",175,84,91,
"180","1996","70-74",128,71,57,
"180","1996","75-79",99,51,48,
"180","1996","80-84",69,25,44,
"180","1996","85+",48,19,29,
"185","1996","0-4",732,392,340,
"185","1996","5-9",863,440,423,
"185","1996","10-14",802,424,378,
"185","1996","15-19",527,265,262,
"185","1996","20-24",397,200,197,
"185","1996","25-29",486,256,230,
"185","1996","30-34",673,362,311,
"185","1996","35-39",616,344,272,
"185","1996","40-44",542,300,242,
"185","1996","45-49",474,280,194,
"185","1996","50-54",323,180,143,
"185","1996","55-59",244,133,111,
"185","1996","60-64",162,87,75,
"185","1996","65-69",94,51,43,
"185","1996","70-74",76,36,40,
"185","1996","75-79",48,21,27,
"185","1996","80-84",33,9,24,
"185","1996","85+",19,7,12,
"188","1996","0-4",694,349,345,
"188","1996","5-9",939,495,444,
"188","1996","10-14",733,384,349,
"188","1996","15-19",546,285,261,
"188","1996","20-24",475,249,226,
"188","1996","25-29",455,259,196,
"188","1996","30-34",581,302,279,
"188","1996","35-39",469,252,217,
"188","1996","40-44",444,279,165,
"188","1996","45-49",330,192,138,
"188","1996","50-54",221,120,101,
"188","1996","55-59",192,107,85,
"188","1996","60-64",156,79,77,
"188","1996","65-69",123,56,67,
"188","1996","70-74",98,45,53,
"188","1996","75-79",38,21,17,
"188","1996","80-84",28,7,21,
"188","1996","85+",22,7,15,
"201","1996","0-4",632,342,290,
"201","1996","5-9",617,289,328,
"201","1996","10-14",667,354,313,
"201","1996","15-19",544,303,241,
"201","1996","20-24",354,201,153,
"201","1996","25-29",467,221,246,
"201","1996","30-34",551,313,238,
"201","1996","35-39",632,315,317,
"201","1996","40-44",691,399,292,
"201","1996","45-49",612,368,244,
"201","1996","50-54",416,228,188,
"201","1996","55-59",302,192,110,
"201","1996","60-64",203,133,70,
"201","1996","65-69",133,72,61,
"201","1996","70-74",93,55,38,
"201","1996","75-79",41,18,23,
"201","1996","80-84",17,10,7,
"201","1996","85+",24,12,12,
"220","1996","0-4",626,327,299,
"220","1996","5-9",702,343,359,
"220","1996","10-14",736,391,345,
"220","1996","15-19",645,371,274,
"220","1996","20-24",551,298,253,
"220","1996","25-29",589,308,281,
"220","1996","30-34",704,370,334,
"220","1996","35-39",817,398,419,
"220","1996","40-44",800,407,393,
"220","1996","45-49",686,366,320,
"220","1996","50-54",463,253,210,
"220","1996","55-59",384,205,179,
"220","1996","60-64",292,149,143,
"220","1996","65-69",194,94,100,
"220","1996","70-74",203,84,119,
"220","1996","75-79",102,53,49,
"220","1996","80-84",85,37,48,
"220","1996","85+",71,13,58,
"232","1996","0-4",217,112,105,
"232","1996","5-9",348,177,171,
"232","1996","10-14",369,215,154,
"232","1996","15-19",299,142,157,
"232","1996","20-24",182,96,86,
"232","1996","25-29",186,93,93,
"232","1996","30-34",287,164,123,
"232","1996","35-39",372,216,156,
"232","1996","40-44",395,219,176,
"232","1996","45-49",355,183,172,
"232","1996","50-54",241,139,102,
"232","1996","55-59",190,106,84,
"232","1996","60-64",132,83,49,
"232","1996","65-69",76,40,36,
"232","1996","70-74",90,45,45,
"232","1996","75-79",38,15,23,
"232","1996","80-84",23,10,13,
"232","1996","85+",23,8,15,
"240","1996","0-4",403,200,203,
"240","1996","5-9",607,301,306,
"240","1996","10-14",697,376,321,
"240","1996","15-19",623,350,273,
"240","1996","20-24",319,190,129,
"240","1996","25-29",319,153,166,
"240","1996","30-34",414,191,223,
"240","1996","35-39",580,283,297,
"240","1996","40-44",639,321,318,
"240","1996","45-49",494,269,225,
"240","1996","50-54",363,215,148,
"240","1996","55-59",311,168,143,
"240","1996","60-64",188,109,79,
"240","1996","65-69",129,65,64,
"240","1996","70-74",106,60,46,
"240","1996","75-79",44,18,26,
"240","1996","80-84",25,11,14,
"240","1996","85+",29,14,15,
"261","1996","0-4",694,335,359,
"261","1996","5-9",963,485,478,
"261","1996","10-14",1026,542,484,
"261","1996","15-19",743,401,342,
"261","1996","20-24",450,236,214,
"261","1996","25-29",614,313,301,
"261","1996","30-34",777,393,384,
"261","1996","35-39",1102,583,519,
"261","1996","40-44",1198,628,570,
"261","1996","45-49",986,565,421,
"261","1996","50-54",637,357,280,
"261","1996","55-59",424,261,163,
"261","1996","60-64",270,165,105,
"261","1996","65-69",206,111,95,
"261","1996","70-74",171,87,84,
"261","1996","75-79",103,51,52,
"261","1996","80-84",46,22,24,
"261","1996","85+",53,25,28,
"270","1996","0-4",779,397,382,
"270","1996","5-9",1013,563,450,
"270","1996","10-14",872,426,446,
"270","1996","15-19",592,301,291,
"270","1996","20-24",486,229,257,
"270","1996","25-29",491,243,248,
"270","1996","30-34",486,263,223,
"270","1996","35-39",446,254,192,
"270","1996","40-44",347,184,163,
"270","1996","45-49",290,160,130,
"270","1996","50-54",225,121,104,
"270","1996","55-59",167,100,67,
"270","1996","60-64",166,77,89,
"270","1996","65-69",135,67,68,
"270","1996","70-74",89,43,46,
"270","1996","75-79",68,34,34,
"270","1996","80-84",25,9,16,
"270","1996","85+",30,15,15,
"280","1996","0-4",517,266,251,
"280","1996","5-9",670,354,316,
"280","1996","10-14",683,357,326,
"280","1996","15-19",476,254,222,
"280","1996","20-24",319,181,138,
"280","1996","25-29",382,192,190,
"280","1996","30-34",539,274,265,
"280","1996","35-39",687,334,353,
"280","1996","40-44",803,434,369,
"280","1996","45-49",590,331,259,
"280","1996","50-54",430,240,190,
"280","1996","55-59",296,169,127,
"280","1996","60-64",178,106,72,
"280","1996","65-69",184,99,85,
"280","1996","70-74",178,89,89,
"280","1996","75-79",132,64,68,
"280","1996","80-84",85,32,53,
"280","1996","85+",53,19,34,
"282","1996","0-4",63,31,32,
"282","1996","5-9",76,39,37,
"282","1996","10-14",75,43,32,
"282","1996","15-19",58,33,25,
"282","1996","20-24",35,22,13,
"282","1996","25-29",53,29,24,
"282","1996","30-34",60,26,34,
"282","1996","35-39",73,45,28,
"282","1996","40-44",101,68,33,
"282","1996","45-49",64,37,27,
"282","1996","50-54",41,24,17,
"282","1996","55-59",40,30,10,
"282","1996","60-64",15,6,9,
"282","1996","65-69",25,18,7,
"282","1996","70-74",14,6,8,
"282","1996","75-79",1,1,0,
"282","1996","80-84",4,2,2,
"282","1996","85+",1,0,1,
"290","1996","0-4",489,239,250,
"290","1996","5-9",729,397,332,
"290","1996","10-14",728,382,346,
"290","1996","15-19",543,314,229,
"290","1996","20-24",354,226,128,
"290","1996","25-29",351,180,171,
"290","1996","30-34",525,280,245,
"290","1996","35-39",540,295,245,
"290","1996","40-44",504,290,214,
"290","1996","45-49",476,259,217,
"290","1996","50-54",304,170,134,
"290","1996","55-59",247,149,98,
"290","1996","60-64",182,91,91,
"290","1996","65-69",141,72,69,
"290","1996","70-74",118,67,51,
"290","1996","75-79",62,30,32,
"290","1996","80-84",43,26,17,
"290","1996","85+",32,17,15,
"000","1997","0-4",48579,24888,23691,
"000","1997","5-9",56187,28781,27406,
"000","1997","10-14",55871,28586,27285,
"000","1997","15-19",46324,24674,21650,
"000","1997","20-24",37985,20314,17671,
"000","1997","25-29",43307,22509,20798,
"000","1997","30-34",50488,25994,24494,
"000","1997","35-39",58669,29954,28715,
"000","1997","40-44",58615,30251,28364,
"000","1997","45-49",48563,25838,22725,
"000","1997","50-54",34924,18829,16095,
"000","1997","55-59",22518,12116,10402,
"000","1997","60-64",15481,8072,7409,
"000","1997","65-69",11816,6003,5813,
"000","1997","70-74",9178,4448,4730,
"000","1997","75-79",5810,2621,3189,
"000","1997","80-84",3088,1264,1824,
"000","1997","85+",2252,789,1463,
"013","1997","0-4",100,52,48,
"013","1997","5-9",122,58,64,
"013","1997","10-14",126,69,57,
"013","1997","15-19",130,80,50,
"013","1997","20-24",212,157,55,
"013","1997","25-29",166,120,46,
"013","1997","30-34",270,179,91,
"013","1997","35-39",276,196,80,
"013","1997","40-44",202,142,60,
"013","1997","45-49",208,125,83,
"013","1997","50-54",205,124,81,
"013","1997","55-59",77,47,30,
"013","1997","60-64",57,39,18,
"013","1997","65-69",28,21,7,
"013","1997","70-74",14,10,4,
"013","1997","75-79",13,6,7,
"013","1997","80-84",6,4,2,
"013","1997","85+",0,0,0,
"016","1997","0-4",279,139,140,
"016","1997","5-9",283,161,122,
"016","1997","10-14",333,161,172,
"016","1997","15-19",210,115,95,
"016","1997","20-24",305,188,117,
"016","1997","25-29",555,364,191,
"016","1997","30-34",781,567,214,
"016","1997","35-39",714,486,228,
"016","1997","40-44",609,419,190,
"016","1997","45-49",527,362,165,
"016","1997","50-54",335,214,121,
"016","1997","55-59",151,91,60,
"016","1997","60-64",134,84,50,
"016","1997","65-69",53,28,25,
"016","1997","70-74",31,17,14,
"016","1997","75-79",19,9,10,
"016","1997","80-84",8,4,4,
"016","1997","85+",6,1,5,
"020","1997","0-4",20783,10527,10256,
"020","1997","5-9",22395,11455,10940,
"020","1997","10-14",21343,10806,10537,
"020","1997","15-19",18290,9530,8760,
"020","1997","20-24",16636,8604,8032,
"020","1997","25-29",19948,10260,9688,
"020","1997","30-34",22279,11257,11022,
"020","1997","35-39",25227,12613,12614,
"020","1997","40-44",24383,12298,12085,
"020","1997","45-49",20139,10291,9848,
"020","1997","50-54",14821,7789,7032,
"020","1997","55-59",9366,4843,4523,
"020","1997","60-64",6346,3206,3140,
"020","1997","65-69",4733,2289,2444,
"020","1997","70-74",3756,1696,2060,
"020","1997","75-79",2295,987,1308,
"020","1997","80-84",1150,446,704,
"020","1997","85+",862,250,612,
"050","1997","0-4",1587,831,756,
"050","1997","5-9",1939,1012,927,
"050","1997","10-14",1793,924,869,
"050","1997","15-19",1371,722,649,
"050","1997","20-24",1008,501,507,
"050","1997","25-29",1083,555,528,
"050","1997","30-34",1318,724,594,
"050","1997","35-39",1251,666,585,
"050","1997","40-44",1082,578,504,
"050","1997","45-49",899,507,392,
"050","1997","50-54",635,346,289,
"050","1997","55-59",474,245,229,
"050","1997","60-64",370,175,195,
"050","1997","65-69",293,166,127,
"050","1997","70-74",196,101,95,
"050","1997","75-79",133,72,61,
"050","1997","80-84",110,51,59,
"050","1997","85+",54,25,29,
"060","1997","0-4",89,44,45,
"060","1997","5-9",139,66,73,
"060","1997","10-14",128,72,56,
"060","1997","15-19",90,38,52,
"060","1997","20-24",50,33,17,
"060","1997","25-29",57,31,26,
"060","1997","30-34",93,51,42,
"060","1997","35-39",141,75,66,
"060","1997","40-44",155,83,72,
"060","1997","45-49",107,62,45,
"060","1997","50-54",84,47,37,
"060","1997","55-59",43,28,15,
"060","1997","60-64",27,13,14,
"060","1997","65-69",21,15,6,
"060","1997","70-74",13,8,5,
"060","1997","75-79",8,3,5,
"060","1997","80-84",3,3,0,
"060","1997","85+",2,1,1,
"068","1997","0-4",114,66,48,
"068","1997","5-9",133,82,51,
"068","1997","10-14",156,78,78,
"068","1997","15-19",144,81,63,
"068","1997","20-24",70,38,32,
"068","1997","25-29",112,63,49,
"068","1997","30-34",159,85,74,
"068","1997","35-39",220,126,94,
"068","1997","40-44",259,161,98,
"068","1997","45-49",209,128,81,
"068","1997","50-54",130,83,47,
"068","1997","55-59",95,62,33,
"068","1997","60-64",47,29,18,
"068","1997","65-69",16,10,6,
"068","1997","70-74",15,11,4,
"068","1997","75-79",8,3,5,
"068","1997","80-84",6,2,4,
"068","1997","85+",2,2,0,
"070","1997","0-4",467,251,216,
"070","1997","5-9",558,304,254,
"070","1997","10-14",487,249,238,
"070","1997","15-19",343,174,169,
"070","1997","20-24",207,114,93,
"070","1997","25-29",271,133,138,
"070","1997","30-34",394,193,201,
"070","1997","35-39",406,224,182,
"070","1997","40-44",382,202,180,
"070","1997","45-49",282,148,134,
"070","1997","50-54",218,117,101,
"070","1997","55-59",149,82,67,
"070","1997","60-64",122,58,64,
"070","1997","65-69",80,43,37,
"070","1997","70-74",73,37,36,
"070","1997","75-79",34,15,19,
"070","1997","80-84",17,7,10,
"070","1997","85+",29,13,16,
"090","1997","0-4",6757,3444,3313,
"090","1997","5-9",7362,3692,3670,
"090","1997","10-14",7216,3680,3536,
"090","1997","15-19",6337,3475,2862,
"090","1997","20-24",7393,4245,3148,
"090","1997","25-29",6924,3726,3198,
"090","1997","30-34",7094,3715,3379,
"090","1997","35-39",7481,3765,3716,
"090","1997","40-44",7287,3663,3624,
"090","1997","45-49",6054,3292,2762,
"090","1997","50-54",4215,2313,1902,
"090","1997","55-59",2664,1421,1243,
"090","1997","60-64",1730,923,807,
"090","1997","65-69",1349,713,636,
"090","1997","70-74",940,448,492,
"090","1997","75-79",668,301,367,
"090","1997","80-84",367,157,210,
"090","1997","85+",226,85,141,
"100","1997","0-4",147,68,79,
"100","1997","5-9",169,88,81,
"100","1997","10-14",224,113,111,
"100","1997","15-19",181,90,91,
"100","1997","20-24",98,50,48,
"100","1997","25-29",94,43,51,
"100","1997","30-34",173,89,84,
"100","1997","35-39",196,96,100,
"100","1997","40-44",271,143,128,
"100","1997","45-49",262,142,120,
"100","1997","50-54",168,79,89,
"100","1997","55-59",104,53,51,
"100","1997","60-64",82,42,40,
"100","1997","65-69",73,39,34,
"100","1997","70-74",75,46,29,
"100","1997","75-79",41,21,20,
"100","1997","80-84",31,12,19,
"100","1997","85+",15,9,6,
"110","1997","0-4",2086,1060,1026,
"110","1997","5-9",2396,1213,1183,
"110","1997","10-14",2510,1302,1208,
"110","1997","15-19",2071,1091,980,
"110","1997","20-24",1566,764,802,
"110","1997","25-29",1974,1009,965,
"110","1997","30-34",2343,1147,1196,
"110","1997","35-39",3028,1529,1499,
"110","1997","40-44",3104,1526,1578,
"110","1997","45-49",2878,1477,1401,
"110","1997","50-54",2028,1089,939,
"110","1997","55-59",1203,633,570,
"110","1997","60-64",750,389,361,
"110","1997","65-69",600,299,301,
"110","1997","70-74",447,206,241,
"110","1997","75-79",373,147,226,
"110","1997","80-84",207,85,122,
"110","1997","85+",149,57,92,
"122","1997","0-4",3429,1791,1638,
"122","1997","5-9",4241,2164,2077,
"122","1997","10-14",4713,2431,2282,
"122","1997","15-19",3829,2086,1743,
"122","1997","20-24",2101,1131,970,
"122","1997","25-29",2668,1405,1263,
"122","1997","30-34",3237,1635,1602,
"122","1997","35-39",4503,2297,2206,
"122","1997","40-44",5137,2633,2504,
"122","1997","45-49",4304,2356,1948,
"122","1997","50-54",2998,1640,1358,
"122","1997","55-59",1944,1075,869,
"122","1997","60-64",1415,735,680,
"122","1997","65-69",1155,581,574,
"122","1997","70-74",973,514,459,
"122","1997","75-79",571,272,299,
"122","1997","80-84",292,126,166,
"122","1997","85+",185,66,119,
"130","1997","0-4",994,506,488,
"130","1997","5-9",1257,646,611,
"130","1997","10-14",1237,633,604,
"130","1997","15-19",1093,581,512,
"130","1997","20-24",687,366,321,
"130","1997","25-29",924,465,459,
"130","1997","30-34",1131,590,541,
"130","1997","35-39",1345,698,647,
"130","1997","40-44",1399,707,692,
"130","1997","45-49",1240,648,592,
"130","1997","50-54",988,530,458,
"130","1997","55-59",667,363,304,
"130","1997","60-64",424,238,186,
"130","1997","65-69",385,192,193,
"130","1997","70-74",299,146,153,
"130","1997","75-79",208,84,124,
"130","1997","80-84",120,43,77,
"130","1997","85+",102,36,66,
"150","1997","0-4",1212,627,585,
"150","1997","5-9",1332,678,654,
"150","1997","10-14",1231,621,610,
"150","1997","15-19",993,540,453,
"150","1997","20-24",893,502,391,
"150","1997","25-29",941,483,458,
"150","1997","30-34",1274,683,591,
"150","1997","35-39",1436,809,627,
"150","1997","40-44",1276,687,589,
"150","1997","45-49",1056,576,480,
"150","1997","50-54",693,386,307,
"150","1997","55-59",417,228,189,
"150","1997","60-64",328,174,154,
"150","1997","65-69",229,125,104,
"150","1997","70-74",160,83,77,
"150","1997","75-79",93,52,41,
"150","1997","80-84",53,27,26,
"150","1997","85+",31,13,18,
"164","1997","0-4",168,86,82,
"164","1997","5-9",224,102,122,
"164","1997","10-14",219,112,107,
"164","1997","15-19",154,89,65,
"164","1997","20-24",79,38,41,
"164","1997","25-29",79,43,36,
"164","1997","30-34",146,74,72,
"164","1997","35-39",172,99,73,
"164","1997","40-44",157,82,75,
"164","1997","45-49",113,66,47,
"164","1997","50-54",70,42,28,
"164","1997","55-59",70,36,34,
"164","1997","60-64",42,26,16,
"164","1997","65-69",38,23,15,
"164","1997","70-74",30,21,9,
"164","1997","75-79",12,6,6,
"164","1997","80-84",9,3,6,
"164","1997","85+",10,2,8,
"170","1997","0-4",3923,2043,1880,
"170","1997","5-9",5032,2642,2390,
"170","1997","10-14",5650,2912,2738,
"170","1997","15-19",4517,2425,2092,
"170","1997","20-24",2219,1148,1071,
"170","1997","25-29",2658,1320,1338,
"170","1997","30-34",3689,1780,1909,
"170","1997","35-39",5358,2668,2690,
"170","1997","40-44",5667,2952,2715,
"170","1997","45-49",4346,2323,2023,
"170","1997","50-54",2924,1590,1334,
"170","1997","55-59",1934,1116,818,
"170","1997","60-64",1355,689,666,
"170","1997","65-69",1133,602,531,
"170","1997","70-74",823,431,392,
"170","1997","75-79",483,237,246,
"170","1997","80-84",261,109,152,
"170","1997","85+",153,54,99,
"180","1997","0-4",803,450,353,
"180","1997","5-9",1123,543,580,
"180","1997","10-14",1004,511,493,
"180","1997","15-19",751,404,347,
"180","1997","20-24",569,308,261,
"180","1997","25-29",611,323,288,
"180","1997","30-34",715,419,296,
"180","1997","35-39",786,427,359,
"180","1997","40-44",700,391,309,
"180","1997","45-49",563,323,240,
"180","1997","50-54",438,247,191,
"180","1997","55-59",302,168,134,
"180","1997","60-64",233,130,103,
"180","1997","65-69",178,91,87,
"180","1997","70-74",128,65,63,
"180","1997","75-79",100,53,47,
"180","1997","80-84",61,22,39,
"180","1997","85+",54,23,31,
"185","1997","0-4",697,389,308,
"185","1997","5-9",908,465,443,
"185","1997","10-14",843,440,403,
"185","1997","15-19",559,283,276,
"185","1997","20-24",403,202,201,
"185","1997","25-29",463,249,214,
"185","1997","30-34",668,354,314,
"185","1997","35-39",618,332,286,
"185","1997","40-44",580,324,256,
"185","1997","45-49",468,273,195,
"185","1997","50-54",358,201,157,
"185","1997","55-59",238,118,120,
"185","1997","60-64",169,96,73,
"185","1997","65-69",96,55,41,
"185","1997","70-74",80,39,41,
"185","1997","75-79",52,19,33,
"185","1997","80-84",31,8,23,
"185","1997","85+",20,10,10,
"188","1997","0-4",674,329,345,
"188","1997","5-9",945,501,444,
"188","1997","10-14",779,406,373,
"188","1997","15-19",602,315,287,
"188","1997","20-24",463,240,223,
"188","1997","25-29",467,270,197,
"188","1997","30-34",570,311,259,
"188","1997","35-39",499,266,233,
"188","1997","40-44",450,273,177,
"188","1997","45-49",348,205,143,
"188","1997","50-54",254,137,117,
"188","1997","55-59",188,100,88,
"188","1997","60-64",150,81,69,
"188","1997","65-69",132,64,68,
"188","1997","70-74",96,44,52,
"188","1997","75-79",42,20,22,
"188","1997","80-84",30,12,18,
"188","1997","85+",23,9,14,
"201","1997","0-4",573,316,257,
"201","1997","5-9",633,310,323,
"201","1997","10-14",647,324,323,
"201","1997","15-19",554,308,246,
"201","1997","20-24",361,195,166,
"201","1997","25-29",423,212,211,
"201","1997","30-34",495,271,224,
"201","1997","35-39",577,274,303,
"201","1997","40-44",689,395,294,
"201","1997","45-49",625,377,248,
"201","1997","50-54",439,254,185,
"201","1997","55-59",318,191,127,
"201","1997","60-64",213,138,75,
"201","1997","65-69",139,73,66,
"201","1997","70-74",91,57,34,
"201","1997","75-79",53,23,30,
"201","1997","80-84",19,11,8,
"201","1997","85+",24,12,12,
"220","1997","0-4",630,336,294,
"220","1997","5-9",691,346,345,
"220","1997","10-14",718,349,369,
"220","1997","15-19",669,380,289,
"220","1997","20-24",542,310,232,
"220","1997","25-29",583,296,287,
"220","1997","30-34",670,337,333,
"220","1997","35-39",805,411,394,
"220","1997","40-44",829,428,401,
"220","1997","45-49",705,376,329,
"220","1997","50-54",517,277,240,
"220","1997","55-59",380,202,178,
"220","1997","60-64",309,154,155,
"220","1997","65-69",202,99,103,
"220","1997","70-74",196,86,110,
"220","1997","75-79",112,50,62,
"220","1997","80-84",76,35,41,
"220","1997","85+",74,17,57,
"232","1997","0-4",193,97,96,
"232","1997","5-9",325,167,158,
"232","1997","10-14",363,212,151,
"232","1997","15-19",290,147,143,
"232","1997","20-24",159,85,74,
"232","1997","25-29",196,94,102,
"232","1997","30-34",247,141,106,
"232","1997","35-39",375,215,160,
"232","1997","40-44",363,205,158,
"232","1997","45-49",346,174,172,
"232","1997","50-54",247,143,104,
"232","1997","55-59",197,111,86,
"232","1997","60-64",128,76,52,
"232","1997","65-69",71,39,32,
"232","1997","70-74",82,43,39,
"232","1997","75-79",42,20,22,
"232","1997","80-84",23,7,16,
"232","1997","85+",21,7,14,
"240","1997","0-4",412,203,209,
"240","1997","5-9",615,304,311,
"240","1997","10-14",692,369,323,
"240","1997","15-19",605,333,272,
"240","1997","20-24",318,178,140,
"240","1997","25-29",307,161,146,
"240","1997","30-34",399,181,218,
"240","1997","35-39",537,269,268,
"240","1997","40-44",648,325,323,
"240","1997","45-49",494,271,223,
"240","1997","50-54",378,211,167,
"240","1997","55-59",315,175,140,
"240","1997","60-64",194,107,87,
"240","1997","65-69",135,73,62,
"240","1997","70-74",98,58,40,
"240","1997","75-79",52,21,31,
"240","1997","80-84",24,9,15,
"240","1997","85+",30,14,16,
"261","1997","0-4",687,337,350,
"261","1997","5-9",894,459,435,
"261","1997","10-14",1018,545,473,
"261","1997","15-19",783,417,366,
"261","1997","20-24",456,255,201,
"261","1997","25-29",578,298,280,
"261","1997","30-34",740,368,372,
"261","1997","35-39",1033,541,492,
"261","1997","40-44",1189,624,565,
"261","1997","45-49",972,560,412,
"261","1997","50-54",696,387,309,
"261","1997","55-59",443,261,182,
"261","1997","60-64",291,178,113,
"261","1997","65-69",203,114,89,
"261","1997","70-74",166,82,84,
"261","1997","75-79",104,54,50,
"261","1997","80-84",45,19,26,
"261","1997","85+",59,30,29,
"270","1997","0-4",775,401,374,
"270","1997","5-9",1032,553,479,
"270","1997","10-14",928,470,458,
"270","1997","15-19",638,325,313,
"270","1997","20-24",503,247,256,
"270","1997","25-29",478,222,256,
"270","1997","30-34",512,267,245,
"270","1997","35-39",461,258,203,
"270","1997","40-44",383,212,171,
"270","1997","45-49",278,152,126,
"270","1997","50-54",231,122,109,
"270","1997","55-59",168,97,71,
"270","1997","60-64",168,76,92,
"270","1997","65-69",126,63,63,
"270","1997","70-74",96,47,49,
"270","1997","75-79",69,34,35,
"270","1997","80-84",22,8,14,
"270","1997","85+",29,14,15,
"280","1997","0-4",494,258,236,
"280","1997","5-9",640,335,305,
"280","1997","10-14",692,359,333,
"280","1997","15-19",503,277,226,
"280","1997","20-24",298,168,130,
"280","1997","25-29",362,177,185,
"280","1997","30-34",529,271,258,
"280","1997","35-39",637,296,341,
"280","1997","40-44",798,426,372,
"280","1997","45-49",584,333,251,
"280","1997","50-54",473,249,224,
"280","1997","55-59",311,183,128,
"280","1997","60-64",198,113,85,
"280","1997","65-69",176,89,87,
"280","1997","70-74",166,81,85,
"280","1997","75-79",151,74,77,
"280","1997","80-84",75,30,45,
"280","1997","85+",55,21,34,
"282","1997","0-4",64,28,36,
"282","1997","5-9",82,50,32,
"282","1997","10-14",76,43,33,
"282","1997","15-19",61,39,22,
"282","1997","20-24",37,26,11,
"282","1997","25-29",57,28,29,
"282","1997","30-34",66,31,35,
"282","1997","35-39",65,42,23,
"282","1997","40-44",99,68,31,
"282","1997","45-49",62,33,29,
"282","1997","50-54",54,31,23,
"282","1997","55-59",43,37,6,
"282","1997","60-64",17,6,11,
"282","1997","65-69",22,14,8,
"282","1997","70-74",11,6,5,
"282","1997","75-79",2,2,0,
"282","1997","80-84",2,1,1,
"282","1997","85+",2,1,1,
"290","1997","0-4",442,209,233,
"290","1997","5-9",717,385,332,
"290","1997","10-14",745,395,350,
"290","1997","15-19",556,329,227,
"290","1997","20-24",352,221,131,
"290","1997","25-29",328,159,169,
"290","1997","30-34",496,274,222,
"290","1997","35-39",522,276,246,
"290","1997","40-44",517,304,213,
"290","1997","45-49",494,258,236,
"290","1997","50-54",327,181,146,
"290","1997","55-59",257,150,107,
"290","1997","60-64",182,97,85,
"290","1997","65-69",150,83,67,
"290","1997","70-74",123,65,58,
"290","1997","75-79",72,36,36,
"290","1997","80-84",40,23,17,
"290","1997","85+",35,17,18,
"000","1998","0-4",47673,24357,23316,
"000","1998","5-9",55761,28675,27086,
"000","1998","10-14",56110,28681,27429,
"000","1998","15-19",48577,25801,22776,
"000","1998","20-24",38650,20604,18046,
"000","1998","25-29",43585,22632,20953,
"000","1998","30-34",48054,24911,23143,
"000","1998","35-39",57944,29558,28386,
"000","1998","40-44",58889,30141,28748,
"000","1998","45-49",50856,26910,23946,
"000","1998","50-54",36822,19789,17033,
"000","1998","55-59",24463,13204,11259,
"000","1998","60-64",16226,8534,7692,
"000","1998","65-69",12082,6070,6012,
"000","1998","70-74",9386,4584,4802,
"000","1998","75-79",6264,2848,3416,
"000","1998","80-84",3374,1372,2002,
"000","1998","85+",2366,813,1553,
"013","1998","0-4",105,55,50,
"013","1998","5-9",111,54,57,
"013","1998","10-14",107,59,48,
"013","1998","15-19",127,81,46,
"013","1998","20-24",214,146,68,
"013","1998","25-29",140,100,40,
"013","1998","30-34",239,158,81,
"013","1998","35-39",268,192,76,
"013","1998","40-44",209,147,62,
"013","1998","45-49",225,137,88,
"013","1998","50-54",196,119,77,
"013","1998","55-59",88,61,27,
"013","1998","60-64",62,37,25,
"013","1998","65-69",27,22,5,
"013","1998","70-74",11,7,4,
"013","1998","75-79",10,5,5,
"013","1998","80-84",6,4,2,
"013","1998","85+",0,0,0,
"016","1998","0-4",286,140,146,
"016","1998","5-9",281,156,125,
"016","1998","10-14",302,157,145,
"016","1998","15-19",235,124,111,
"016","1998","20-24",285,165,120,
"016","1998","25-29",520,339,181,
"016","1998","30-34",752,549,203,
"016","1998","35-39",740,500,240,
"016","1998","40-44",618,429,189,
"016","1998","45-49",550,356,194,
"016","1998","50-54",383,262,121,
"016","1998","55-59",164,95,69,
"016","1998","60-64",124,78,46,
"016","1998","65-69",42,21,21,
"016","1998","70-74",31,17,14,
"016","1998","75-79",18,8,10,
"016","1998","80-84",7,4,3,
"016","1998","85+",8,1,7,
"020","1998","0-4",20184,10178,10006,
"020","1998","5-9",22333,11422,10911,
"020","1998","10-14",21265,10816,10449,
"020","1998","15-19",19253,9969,9284,
"020","1998","20-24",16746,8672,8074,
"020","1998","25-29",20080,10349,9731,
"020","1998","30-34",21257,10852,10405,
"020","1998","35-39",25063,12509,12554,
"020","1998","40-44",24328,12091,12237,
"020","1998","45-49",21041,10794,10247,
"020","1998","50-54",15585,8125,7460,
"020","1998","55-59",10167,5312,4855,
"020","1998","60-64",6638,3348,3290,
"020","1998","65-69",4827,2326,2501,
"020","1998","70-74",3787,1720,2067,
"020","1998","75-79",2497,1066,1431,
"020","1998","80-84",1294,504,790,
"020","1998","85+",915,267,648,
"050","1998","0-4",1574,827,747,
"050","1998","5-9",1977,1043,934,
"050","1998","10-14",1842,945,897,
"050","1998","15-19",1444,761,683,
"050","1998","20-24",1001,513,488,
"050","1998","25-29",1063,533,530,
"050","1998","30-34",1261,691,570,
"050","1998","35-39",1323,712,611,
"050","1998","40-44",1144,614,530,
"050","1998","45-49",973,544,429,
"050","1998","50-54",655,367,288,
"050","1998","55-59",499,263,236,
"050","1998","60-64",365,180,185,
"050","1998","65-69",291,153,138,
"050","1998","70-74",209,111,98,
"050","1998","75-79",137,79,58,
"050","1998","80-84",120,51,69,
"050","1998","85+",57,25,32,
"060","1998","0-4",98,46,52,
"060","1998","5-9",132,69,63,
"060","1998","10-14",137,67,70,
"060","1998","15-19",95,45,50,
"060","1998","20-24",55,37,18,
"060","1998","25-29",57,30,27,
"060","1998","30-34",93,49,44,
"060","1998","35-39",156,82,74,
"060","1998","40-44",140,78,62,
"060","1998","45-49",123,60,63,
"060","1998","50-54",91,61,30,
"060","1998","55-59",44,27,17,
"060","1998","60-64",29,16,13,
"060","1998","65-69",16,13,3,
"060","1998","70-74",14,7,7,
"060","1998","75-79",6,2,4,
"060","1998","80-84",3,3,0,
"060","1998","85+",2,1,1,
"068","1998","0-4",107,62,45,
"068","1998","5-9",135,80,55,
"068","1998","10-14",134,68,66,
"068","1998","15-19",148,81,67,
"068","1998","20-24",89,59,30,
"068","1998","25-29",116,63,53,
"068","1998","30-34",139,79,60,
"068","1998","35-39",205,113,92,
"068","1998","40-44",248,149,99,
"068","1998","45-49",214,130,84,
"068","1998","50-54",135,87,48,
"068","1998","55-59",97,63,34,
"068","1998","60-64",45,25,20,
"068","1998","65-69",22,17,5,
"068","1998","70-74",15,10,5,
"068","1998","75-79",10,5,5,
"068","1998","80-84",6,2,4,
"068","1998","85+",3,3,0,
"070","1998","0-4",479,253,226,
"070","1998","5-9",549,301,248,
"070","1998","10-14",543,280,263,
"070","1998","15-19",353,193,160,
"070","1998","20-24",234,117,117,
"070","1998","25-29",261,134,127,
"070","1998","30-34",372,182,190,
"070","1998","35-39",412,218,194,
"070","1998","40-44",396,219,177,
"070","1998","45-49",322,160,162,
"070","1998","50-54",222,121,101,
"070","1998","55-59",174,93,81,
"070","1998","60-64",114,56,58,
"070","1998","65-69",96,53,43,
"070","1998","70-74",68,30,38,
"070","1998","75-79",42,21,21,
"070","1998","80-84",19,9,10,
"070","1998","85+",30,12,18,
"090","1998","0-4",6774,3491,3283,
"090","1998","5-9",7304,3708,3596,
"090","1998","10-14",7290,3742,3548,
"090","1998","15-19",6542,3566,2976,
"090","1998","20-24",7490,4208,3282,
"090","1998","25-29",7120,3893,3227,
"090","1998","30-34",6699,3460,3239,
"090","1998","35-39",7401,3698,3703,
"090","1998","40-44",7334,3658,3676,
"090","1998","45-49",6341,3451,2890,
"090","1998","50-54",4358,2366,1992,
"090","1998","55-59",2926,1566,1360,
"090","1998","60-64",1795,977,818,
"090","1998","65-69",1362,710,652,
"090","1998","70-74",1004,491,513,
"090","1998","75-79",680,307,373,
"090","1998","80-84",378,156,222,
"090","1998","85+",247,101,146,
"100","1998","0-4",147,74,73,
"100","1998","5-9",155,75,80,
"100","1998","10-14",205,103,102,
"100","1998","15-19",193,94,99,
"100","1998","20-24",98,48,50,
"100","1998","25-29",105,49,56,
"100","1998","30-34",165,85,80,
"100","1998","35-39",203,96,107,
"100","1998","40-44",261,137,124,
"100","1998","45-49",281,150,131,
"100","1998","50-54",196,101,95,
"100","1998","55-59",119,65,54,
"100","1998","60-64",89,43,46,
"100","1998","65-69",79,37,42,
"100","1998","70-74",62,36,26,
"100","1998","75-79",47,24,23,
"100","1998","80-84",39,19,20,
"100","1998","85+",17,9,8,
"110","1998","0-4",1985,998,987,
"110","1998","5-9",2420,1208,1212,
"110","1998","10-14",2539,1323,1216,
"110","1998","15-19",2164,1137,1027,
"110","1998","20-24",1608,803,805,
"110","1998","25-29",1926,977,949,
"110","1998","30-34",2262,1131,1131,
"110","1998","35-39",2993,1502,1491,
"110","1998","40-44",3090,1529,1561,
"110","1998","45-49",2927,1474,1453,
"110","1998","50-54",2167,1145,1022,
"110","1998","55-59",1329,694,635,
"110","1998","60-64",817,434,383,
"110","1998","65-69",569,283,286,
"110","1998","70-74",467,221,246,
"110","1998","75-79",374,151,223,
"110","1998","80-84",234,88,146,
"110","1998","85+",150,58,92,
"122","1998","0-4",3384,1743,1641,
"122","1998","5-9",4179,2130,2049,
"122","1998","10-14",4695,2431,2264,
"122","1998","15-19",4000,2145,1855,
"122","1998","20-24",2199,1189,1010,
"122","1998","25-29",2689,1419,1270,
"122","1998","30-34",3107,1588,1519,
"122","1998","35-39",4339,2245,2094,
"122","1998","40-44",5121,2597,2524,
"122","1998","45-49",4564,2459,2105,
"122","1998","50-54",3238,1772,1466,
"122","1998","55-59",2241,1226,1015,
"122","1998","60-64",1470,768,702,
"122","1998","65-69",1190,596,594,
"122","1998","70-74",977,509,468,
"122","1998","75-79",621,295,326,
"122","1998","80-84",321,136,185,
"122","1998","85+",197,65,132,
"130","1998","0-4",960,500,460,
"130","1998","5-9",1208,618,590,
"130","1998","10-14",1193,631,562,
"130","1998","15-19",1037,539,498,
"130","1998","20-24",677,364,313,
"130","1998","25-29",913,442,471,
"130","1998","30-34",1033,524,509,
"130","1998","35-39",1297,705,592,
"130","1998","40-44",1359,695,664,
"130","1998","45-49",1175,602,573,
"130","1998","50-54",992,531,461,
"130","1998","55-59",716,382,334,
"130","1998","60-64",447,260,187,
"130","1998","65-69",369,184,185,
"130","1998","70-74",312,156,156,
"130","1998","75-79",218,93,125,
"130","1998","80-84",137,54,83,
"130","1998","85+",100,32,68,
"150","1998","0-4",1226,611,615,
"150","1998","5-9",1333,679,654,
"150","1998","10-14",1235,607,628,
"150","1998","15-19",1035,577,458,
"150","1998","20-24",854,478,376,
"150","1998","25-29",935,473,462,
"150","1998","30-34",1195,646,549,
"150","1998","35-39",1391,759,632,
"150","1998","40-44",1291,706,585,
"150","1998","45-49",1100,599,501,
"150","1998","50-54",738,410,328,
"150","1998","55-59",444,234,210,
"150","1998","60-64",323,176,147,
"150","1998","65-69",246,145,101,
"150","1998","70-74",168,79,89,
"150","1998","75-79",104,59,45,
"150","1998","80-84",64,29,35,
"150","1998","85+",34,17,17,
"164","1998","0-4",170,84,86,
"164","1998","5-9",234,114,120,
"164","1998","10-14",218,111,107,
"164","1998","15-19",185,107,78,
"164","1998","20-24",89,40,49,
"164","1998","25-29",71,37,34,
"164","1998","30-34",127,70,57,
"164","1998","35-39",169,100,69,
"164","1998","40-44",172,88,84,
"164","1998","45-49",112,58,54,
"164","1998","50-54",78,47,31,
"164","1998","55-59",72,41,31,
"164","1998","60-64",44,27,17,
"164","1998","65-69",38,22,16,
"164","1998","70-74",27,19,8,
"164","1998","75-79",19,11,8,
"164","1998","80-84",9,3,6,
"164","1998","85+",8,2,6,
"170","1998","0-4",3954,2055,1899,
"170","1998","5-9",5042,2644,2398,
"170","1998","10-14",5772,2974,2798,
"170","1998","15-19",4859,2628,2231,
"170","1998","20-24",2478,1299,1179,
"170","1998","25-29",2789,1381,1408,
"170","1998","30-34",3543,1744,1799,
"170","1998","35-39",5303,2649,2654,
"170","1998","40-44",5947,3118,2829,
"170","1998","45-49",4706,2495,2211,
"170","1998","50-54",3135,1683,1452,
"170","1998","55-59",2124,1217,907,
"170","1998","60-64",1474,779,695,
"170","1998","65-69",1179,603,576,
"170","1998","70-74",872,462,410,
"170","1998","75-79",537,270,267,
"170","1998","80-84",269,115,154,
"170","1998","85+",170,56,114,
"180","1998","0-4",792,430,362,
"180","1998","5-9",1122,565,557,
"180","1998","10-14",1038,530,508,
"180","1998","15-19",790,412,378,
"180","1998","20-24",639,340,299,
"180","1998","25-29",639,323,316,
"180","1998","30-34",660,389,271,
"180","1998","35-39",782,430,352,
"180","1998","40-44",734,406,328,
"180","1998","45-49",598,345,253,
"180","1998","50-54",460,268,192,
"180","1998","55-59",314,163,151,
"180","1998","60-64",234,126,108,
"180","1998","65-69",185,101,84,
"180","1998","70-74",136,65,71,
"180","1998","75-79",107,57,50,
"180","1998","80-84",56,19,37,
"180","1998","85+",55,21,34,
"185","1998","0-4",655,375,280,
"185","1998","5-9",898,453,445,
"185","1998","10-14",853,436,417,
"185","1998","15-19",627,337,290,
"185","1998","20-24",428,204,224,
"185","1998","25-29",435,229,206,
"185","1998","30-34",617,342,275,
"185","1998","35-39",598,308,290,
"185","1998","40-44",575,309,266,
"185","1998","45-49",503,290,213,
"185","1998","50-54",364,202,162,
"185","1998","55-59",245,130,115,
"185","1998","60-64",178,95,83,
"185","1998","65-69",103,58,45,
"185","1998","70-74",75,38,37,
"185","1998","75-79",59,22,37,
"185","1998","80-84",32,8,24,
"185","1998","85+",23,9,14,
"188","1998","0-4",693,344,349,
"188","1998","5-9",897,473,424,
"188","1998","10-14",811,414,397,
"188","1998","15-19",633,334,299,
"188","1998","20-24",440,235,205,
"188","1998","25-29",470,257,213,
"188","1998","30-34",586,335,251,
"188","1998","35-39",489,262,227,
"188","1998","40-44",479,282,197,
"188","1998","45-49",349,208,141,
"188","1998","50-54",284,155,129,
"188","1998","55-59",190,102,88,
"188","1998","60-64",143,79,64,
"188","1998","65-69",140,67,73,
"188","1998","70-74",107,51,56,
"188","1998","75-79",51,22,29,
"188","1998","80-84",26,10,16,
"188","1998","85+",29,12,17,
"201","1998","0-4",540,287,253,
"201","1998","5-9",588,308,280,
"201","1998","10-14",647,318,329,
"201","1998","15-19",551,314,237,
"201","1998","20-24",360,198,162,
"201","1998","25-29",402,193,209,
"201","1998","30-34",506,264,242,
"201","1998","35-39",579,299,280,
"201","1998","40-44",671,367,304,
"201","1998","45-49",640,381,259,
"201","1998","50-54",426,251,175,
"201","1998","55-59",342,198,144,
"201","1998","60-64",235,155,80,
"201","1998","65-69",134,68,66,
"201","1998","70-74",110,68,42,
"201","1998","75-79",64,30,34,
"201","1998","80-84",17,11,6,
"201","1998","85+",18,10,8,
"220","1998","0-4",567,292,275,
"220","1998","5-9",669,355,314,
"220","1998","10-14",733,330,403,
"220","1998","15-19",697,391,306,
"220","1998","20-24",554,321,233,
"220","1998","25-29",570,280,290,
"220","1998","30-34",632,327,305,
"220","1998","35-39",758,396,362,
"220","1998","40-44",832,413,419,
"220","1998","45-49",756,389,367,
"220","1998","50-54",525,276,249,
"220","1998","55-59",384,220,164,
"220","1998","60-64",334,167,167,
"220","1998","65-69",236,115,121,
"220","1998","70-74",186,85,101,
"220","1998","75-79",128,59,69,
"220","1998","80-84",80,37,43,
"220","1998","85+",81,16,65,
"232","1998","0-4",196,103,93,
"232","1998","5-9",301,160,141,
"232","1998","10-14",345,184,161,
"232","1998","15-19",302,157,145,
"232","1998","20-24",176,99,77,
"232","1998","25-29",189,97,92,
"232","1998","30-34",229,126,103,
"232","1998","35-39",339,188,151,
"232","1998","40-44",363,206,157,
"232","1998","45-49",359,172,187,
"232","1998","50-54",254,160,94,
"232","1998","55-59",201,105,96,
"232","1998","60-64",150,92,58,
"232","1998","65-69",78,42,36,
"232","1998","70-74",64,31,33,
"232","1998","75-79",53,30,23,
"232","1998","80-84",25,6,19,
"232","1998","85+",18,6,12,
"240","1998","0-4",438,224,214,
"240","1998","5-9",591,294,297,
"240","1998","10-14",668,337,331,
"240","1998","15-19",604,320,284,
"240","1998","20-24",312,164,148,
"240","1998","25-29",346,185,161,
"240","1998","30-34",396,177,219,
"240","1998","35-39",507,246,261,
"240","1998","40-44",629,317,312,
"240","1998","45-49",521,292,229,
"240","1998","50-54",404,217,187,
"240","1998","55-59",343,192,151,
"240","1998","60-64",222,123,99,
"240","1998","65-69",146,76,70,
"240","1998","70-74",114,66,48,
"240","1998","75-79",53,25,28,
"240","1998","80-84",27,11,16,
"240","1998","85+",28,10,18,
"261","1998","0-4",641,289,352,
"261","1998","5-9",865,462,403,
"261","1998","10-14",1010,526,484,
"261","1998","15-19",815,430,385,
"261","1998","20-24",434,252,182,
"261","1998","25-29",559,276,283,
"261","1998","30-34",679,342,337,
"261","1998","35-39",989,505,484,
"261","1998","40-44",1157,599,558,
"261","1998","45-49",991,553,438,
"261","1998","50-54",756,424,332,
"261","1998","55-59",478,300,178,
"261","1998","60-64",293,172,121,
"261","1998","65-69",214,119,95,
"261","1998","70-74",168,91,77,
"261","1998","75-79",115,53,62,
"261","1998","80-84",59,26,33,
"261","1998","85+",51,30,21,
"270","1998","0-4",750,401,349,
"270","1998","5-9",1044,566,478,
"270","1998","10-14",1001,498,503,
"270","1998","15-19",679,360,319,
"270","1998","20-24",485,234,251,
"270","1998","25-29",488,231,257,
"270","1998","30-34",495,259,236,
"270","1998","35-39",471,260,211,
"270","1998","40-44",396,220,176,
"270","1998","45-49",293,158,135,
"270","1998","50-54",250,135,115,
"270","1998","55-59",161,92,69,
"270","1998","60-64",168,81,87,
"270","1998","65-69",142,65,77,
"270","1998","70-74",87,42,45,
"270","1998","75-79",80,39,41,
"270","1998","80-84",23,11,12,
"270","1998","85+",31,12,19,
"280","1998","0-4",483,254,229,
"280","1998","5-9",618,318,300,
"280","1998","10-14",715,368,347,
"280","1998","15-19",521,297,224,
"280","1998","20-24",297,158,139,
"280","1998","25-29",353,174,179,
"280","1998","30-34",508,262,246,
"280","1998","35-39",591,278,313,
"280","1998","40-44",767,405,362,
"280","1998","45-49",615,341,274,
"280","1998","50-54",514,273,241,
"280","1998","55-59",314,186,128,
"280","1998","60-64",220,122,98,
"280","1998","65-69",192,94,98,
"280","1998","70-74",165,86,79,
"280","1998","75-79",158,79,79,
"280","1998","80-84",78,29,49,
"280","1998","85+",56,21,35,
"282","1998","0-4",48,22,26,
"282","1998","5-9",76,45,31,
"282","1998","10-14",68,41,27,
"282","1998","15-19",52,31,21,
"282","1998","20-24",36,23,13,
"282","1998","25-29",43,18,25,
"282","1998","30-34",67,34,33,
"282","1998","35-39",57,35,22,
"282","1998","40-44",97,65,32,
"282","1998","45-49",74,45,29,
"282","1998","50-54",56,31,25,
"282","1998","55-59",41,33,8,
"282","1998","60-64",22,12,10,
"282","1998","65-69",17,9,8,
"282","1998","70-74",16,10,6,
"282","1998","75-79",3,1,2,
"282","1998","80-84",0,0,0,
"282","1998","85+",2,1,1,
"290","1998","0-4",437,219,218,
"290","1998","5-9",699,375,324,
"290","1998","10-14",744,385,359,
"290","1998","15-19",636,371,265,
"290","1998","20-24",372,238,134,
"290","1998","25-29",306,150,156,
"290","1998","30-34",435,246,189,
"290","1998","35-39",521,271,250,
"290","1998","40-44",531,297,234,
"290","1998","45-49",503,267,236,
"290","1998","50-54",360,200,160,
"290","1998","55-59",246,144,102,
"290","1998","60-64",191,106,85,
"290","1998","65-69",142,71,71,
"290","1998","70-74",134,76,58,
"290","1998","75-79",73,35,38,
"290","1998","80-84",45,27,18,
"290","1998","85+",36,16,20,
"000","1999","0-4",47105,24092,23013,
"000","1999","5-9",54651,28032,26619,
"000","1999","10-14",56376,28891,27485,
"000","1999","15-19",49896,26345,23551,
"000","1999","20-24",39349,20987,18362,
"000","1999","25-29",42711,22166,20545,
"000","1999","30-34",46495,24040,22455,
"000","1999","35-39",56795,29105,27690,
"000","1999","40-44",58478,29781,28697,
"000","1999","45-49",52526,27654,24872,
"000","1999","50-54",39356,21132,18224,
"000","1999","55-59",26309,14174,12135,
"000","1999","60-64",16924,8947,7977,
"000","1999","65-69",12389,6262,6127,
"000","1999","70-74",9742,4791,4951,
"000","1999","75-79",6732,3007,3725,
"000","1999","80-84",3575,1487,2088,
"000","1999","85+",2591,898,1693,
"013","1999","0-4",105,52,53,
"013","1999","5-9",94,47,47,
"013","1999","10-14",104,53,51,
"013","1999","15-19",131,83,48,
"013","1999","20-24",188,115,73,
"013","1999","25-29",153,104,49,
"013","1999","30-34",243,168,75,
"013","1999","35-39",289,215,74,
"013","1999","40-44",217,148,69,
"013","1999","45-49",220,141,79,
"013","1999","50-54",196,119,77,
"013","1999","55-59",100,64,36,
"013","1999","60-64",66,42,24,
"013","1999","65-69",18,14,4,
"013","1999","70-74",12,9,3,
"013","1999","75-79",10,6,4,
"013","1999","80-84",5,3,2,
"013","1999","85+",0,0,0,
"016","1999","0-4",261,141,120,
"016","1999","5-9",266,147,119,
"016","1999","10-14",270,137,133,
"016","1999","15-19",241,132,109,
"016","1999","20-24",305,184,121,
"016","1999","25-29",452,307,145,
"016","1999","30-34",745,539,206,
"016","1999","35-39",718,481,237,
"016","1999","40-44",650,448,202,
"016","1999","45-49",540,344,196,
"016","1999","50-54",414,281,133,
"016","1999","55-59",183,112,71,
"016","1999","60-64",123,72,51,
"016","1999","65-69",53,27,26,
"016","1999","70-74",32,19,13,
"016","1999","75-79",21,8,13,
"016","1999","80-84",5,2,3,
"016","1999","85+",6,2,4,
"020","1999","0-4",19953,10071,9882,
"020","1999","5-9",22093,11327,10766,
"020","1999","10-14",21454,11018,10436,
"020","1999","15-19",19549,10050,9499,
"020","1999","20-24",17376,9018,8358,
"020","1999","25-29",19632,10122,9510,
"020","1999","30-34",20497,10363,10134,
"020","1999","35-39",24576,12372,12204,
"020","1999","40-44",24494,12089,12405,
"020","1999","45-49",21556,11051,10505,
"020","1999","50-54",16466,8564,7902,
"020","1999","55-59",10903,5682,5221,
"020","1999","60-64",6918,3509,3409,
"020","1999","65-69",4902,2369,2533,
"020","1999","70-74",3892,1789,2103,
"020","1999","75-79",2731,1146,1585,
"020","1999","80-84",1380,545,835,
"020","1999","85+",1019,300,719,
"050","1999","0-4",1578,845,733,
"050","1999","5-9",1967,1032,935,
"050","1999","10-14",1879,983,896,
"050","1999","15-19",1529,812,717,
"050","1999","20-24",1049,541,508,
"050","1999","25-29",1040,533,507,
"050","1999","30-34",1194,629,565,
"050","1999","35-39",1317,721,596,
"050","1999","40-44",1179,633,546,
"050","1999","45-49",971,553,418,
"050","1999","50-54",702,392,310,
"050","1999","55-59",575,307,268,
"050","1999","60-64",336,175,161,
"050","1999","65-69",299,143,156,
"050","1999","70-74",227,126,101,
"050","1999","75-79",140,78,62,
"050","1999","80-84",122,56,66,
"050","1999","85+",63,26,37,
"060","1999","0-4",81,37,44,
"060","1999","5-9",120,62,58,
"060","1999","10-14",131,67,64,
"060","1999","15-19",105,47,58,
"060","1999","20-24",52,39,13,
"060","1999","25-29",61,30,31,
"060","1999","30-34",68,32,36,
"060","1999","35-39",147,78,69,
"060","1999","40-44",150,86,64,
"060","1999","45-49",120,60,60,
"060","1999","50-54",96,63,33,
"060","1999","55-59",43,26,17,
"060","1999","60-64",33,18,15,
"060","1999","65-69",23,16,7,
"060","1999","70-74",14,9,5,
"060","1999","75-79",7,3,4,
"060","1999","80-84",4,4,0,
"060","1999","85+",3,1,2,
"068","1999","0-4",101,58,43,
"068","1999","5-9",120,66,54,
"068","1999","10-14",146,77,69,
"068","1999","15-19",140,76,64,
"068","1999","20-24",88,60,28,
"068","1999","25-29",98,55,43,
"068","1999","30-34",155,98,57,
"068","1999","35-39",208,112,96,
"068","1999","40-44",232,140,92,
"068","1999","45-49",227,132,95,
"068","1999","50-54",140,88,52,
"068","1999","55-59",110,73,37,
"068","1999","60-64",51,31,20,
"068","1999","65-69",23,17,6,
"068","1999","70-74",15,9,6,
"068","1999","75-79",9,4,5,
"068","1999","80-84",5,2,3,
"068","1999","85+",3,3,0,
"070","1999","0-4",460,242,218,
"070","1999","5-9",540,295,245,
"070","1999","10-14",547,285,262,
"070","1999","15-19",393,213,180,
"070","1999","20-24",232,118,114,
"070","1999","25-29",261,127,134,
"070","1999","30-34",353,178,175,
"070","1999","35-39",421,235,186,
"070","1999","40-44",392,202,190,
"070","1999","45-49",338,179,159,
"070","1999","50-54",223,116,107,
"070","1999","55-59",183,94,89,
"070","1999","60-64",121,59,62,
"070","1999","65-69",88,49,39,
"070","1999","70-74",81,38,43,
"070","1999","75-79",45,23,22,
"070","1999","80-84",27,11,16,
"070","1999","85+",26,13,13,
"090","1999","0-4",6647,3435,3212,
"090","1999","5-9",7192,3645,3547,
"090","1999","10-14",7329,3755,3574,
"090","1999","15-19",6827,3726,3101,
"090","1999","20-24",7363,4108,3255,
"090","1999","25-29",7057,3805,3252,
"090","1999","30-34",6485,3378,3107,
"090","1999","35-39",7391,3696,3695,
"090","1999","40-44",7226,3626,3600,
"090","1999","45-49",6566,3475,3091,
"090","1999","50-54",4814,2630,2184,
"090","1999","55-59",3120,1675,1445,
"090","1999","60-64",1837,1003,834,
"090","1999","65-69",1420,722,698,
"090","1999","70-74",1054,545,509,
"090","1999","75-79",731,316,415,
"090","1999","80-84",441,189,252,
"090","1999","85+",273,111,162,
"100","1999","0-4",132,66,66,
"100","1999","5-9",163,75,88,
"100","1999","10-14",194,93,101,
"100","1999","15-19",191,97,94,
"100","1999","20-24",102,47,55,
"100","1999","25-29",93,43,50,
"100","1999","30-34",148,77,71,
"100","1999","35-39",204,96,108,
"100","1999","40-44",256,132,124,
"100","1999","45-49",269,148,121,
"100","1999","50-54",233,121,112,
"100","1999","55-59",134,68,66,
"100","1999","60-64",85,44,41,
"100","1999","65-69",95,46,49,
"100","1999","70-74",63,38,25,
"100","1999","75-79",51,27,24,
"100","1999","80-84",39,17,22,
"100","1999","85+",23,12,11,
"110","1999","0-4",1938,992,946,
"110","1999","5-9",2404,1184,1220,
"110","1999","10-14",2511,1298,1213,
"110","1999","15-19",2263,1195,1068,
"110","1999","20-24",1604,808,796,
"110","1999","25-29",1935,953,982,
"110","1999","30-34",2281,1159,1122,
"110","1999","35-39",2804,1410,1394,
"110","1999","40-44",3011,1501,1510,
"110","1999","45-49",2966,1482,1484,
"110","1999","50-54",2342,1219,1123,
"110","1999","55-59",1405,740,665,
"110","1999","60-64",859,446,413,
"110","1999","65-69",564,292,272,
"110","1999","70-74",506,235,271,
"110","1999","75-79",378,152,226,
"110","1999","80-84",250,96,154,
"110","1999","85+",168,62,106,
"122","1999","0-4",3314,1678,1636,
"122","1999","5-9",4066,2101,1965,
"122","1999","10-14",4682,2369,2313,
"122","1999","15-19",4141,2223,1918,
"122","1999","20-24",2182,1201,981,
"122","1999","25-29",2600,1375,1225,
"122","1999","30-34",3031,1545,1486,
"122","1999","35-39",4235,2168,2067,
"122","1999","40-44",4943,2526,2417,
"122","1999","45-49",4802,2562,2240,
"122","1999","50-54",3446,1890,1556,
"122","1999","55-59",2472,1354,1118,
"122","1999","60-64",1561,818,743,
"122","1999","65-69",1249,652,597,
"122","1999","70-74",999,513,486,
"122","1999","75-79",692,327,365,
"122","1999","80-84",331,135,196,
"122","1999","85+",206,76,130,
"130","1999","0-4",932,466,466,
"130","1999","5-9",1161,605,556,
"130","1999","10-14",1155,601,554,
"130","1999","15-19",1064,542,522,
"130","1999","20-24",666,347,319,
"130","1999","25-29",809,397,412,
"130","1999","30-34",980,495,485,
"130","1999","35-39",1295,703,592,
"130","1999","40-44",1343,669,674,
"130","1999","45-49",1185,630,555,
"130","1999","50-54",1033,551,482,
"130","1999","55-59",741,394,347,
"130","1999","60-64",472,266,206,
"130","1999","65-69",349,183,166,
"130","1999","70-74",309,149,160,
"130","1999","75-79",237,98,139,
"130","1999","80-84",128,56,72,
"130","1999","85+",102,32,70,
"150","1999","0-4",1224,615,609,
"150","1999","5-9",1288,631,657,
"150","1999","10-14",1303,663,640,
"150","1999","15-19",1057,574,483,
"150","1999","20-24",853,475,378,
"150","1999","25-29",942,501,441,
"150","1999","30-34",1143,621,522,
"150","1999","35-39",1417,766,651,
"150","1999","40-44",1283,695,588,
"150","1999","45-49",1146,630,516,
"150","1999","50-54",821,456,365,
"150","1999","55-59",510,273,237,
"150","1999","60-64",341,188,153,
"150","1999","65-69",256,146,110,
"150","1999","70-74",185,89,96,
"150","1999","75-79",118,67,51,
"150","1999","80-84",62,27,35,
"150","1999","85+",40,22,18,
"164","1999","0-4",147,72,75,
"164","1999","5-9",217,108,109,
"164","1999","10-14",217,104,113,
"164","1999","15-19",183,106,77,
"164","1999","20-24",84,41,43,
"164","1999","25-29",79,38,41,
"164","1999","30-34",108,56,52,
"164","1999","35-39",160,94,66,
"164","1999","40-44",169,88,81,
"164","1999","45-49",137,70,67,
"164","1999","50-54",61,41,20,
"164","1999","55-59",79,40,39,
"164","1999","60-64",49,32,17,
"164","1999","65-69",36,19,17,
"164","1999","70-74",27,20,7,
"164","1999","75-79",19,11,8,
"164","1999","80-84",11,4,7,
"164","1999","85+",8,2,6,
"170","1999","0-4",4013,2078,1935,
"170","1999","5-9",4958,2559,2399,
"170","1999","10-14",5846,3031,2815,
"170","1999","15-19",5021,2725,2296,
"170","1999","20-24",2650,1427,1223,
"170","1999","25-29",2823,1404,1419,
"170","1999","30-34",3557,1765,1792,
"170","1999","35-39",5149,2568,2581,
"170","1999","40-44",5913,3067,2846,
"170","1999","45-49",5150,2707,2443,
"170","1999","50-54",3467,1884,1583,
"170","1999","55-59",2344,1316,1028,
"170","1999","60-64",1563,843,720,
"170","1999","65-69",1240,637,603,
"170","1999","70-74",931,499,432,
"170","1999","75-79",566,269,297,
"170","1999","80-84",309,143,166,
"170","1999","85+",194,66,128,
"180","1999","0-4",777,423,354,
"180","1999","5-9",1088,550,538,
"180","1999","10-14",1056,531,525,
"180","1999","15-19",814,429,385,
"180","1999","20-24",613,319,294,
"180","1999","25-29",635,325,310,
"180","1999","30-34",654,369,285,
"180","1999","35-39",729,414,315,
"180","1999","40-44",730,409,321,
"180","1999","45-49",624,351,273,
"180","1999","50-54",484,293,191,
"180","1999","55-59",329,174,155,
"180","1999","60-64",245,133,112,
"180","1999","65-69",175,96,79,
"180","1999","70-74",142,65,77,
"180","1999","75-79",103,58,45,
"180","1999","80-84",49,18,31,
"180","1999","85+",64,21,43,
"185","1999","0-4",690,392,298,
"185","1999","5-9",839,413,426,
"185","1999","10-14",881,455,426,
"185","1999","15-19",692,359,333,
"185","1999","20-24",469,232,237,
"185","1999","25-29",440,229,211,
"185","1999","30-34",576,317,259,
"185","1999","35-39",584,303,281,
"185","1999","40-44",595,311,284,
"185","1999","45-49",515,299,216,
"185","1999","50-54",375,207,168,
"185","1999","55-59",267,149,118,
"185","1999","60-64",182,96,86,
"185","1999","65-69",116,64,52,
"185","1999","70-74",75,34,41,
"185","1999","75-79",62,26,36,
"185","1999","80-84",34,10,24,
"185","1999","85+",21,6,15,
"188","1999","0-4",696,350,346,
"188","1999","5-9",831,435,396,
"188","1999","10-14",845,423,422,
"188","1999","15-19",674,352,322,
"188","1999","20-24",454,231,223,
"188","1999","25-29",473,247,226,
"188","1999","30-34",560,325,235,
"188","1999","35-39",498,269,229,
"188","1999","40-44",466,272,194,
"188","1999","45-49",376,222,154,
"188","1999","50-54",303,170,133,
"188","1999","55-59",200,103,97,
"188","1999","60-64",151,89,62,
"188","1999","65-69",135,65,70,
"188","1999","70-74",101,49,52,
"188","1999","75-79",58,25,33,
"188","1999","80-84",20,11,9,
"188","1999","85+",32,13,19,
"201","1999","0-4",506,260,246,
"201","1999","5-9",572,294,278,
"201","1999","10-14",580,295,285,
"201","1999","15-19",567,298,269,
"201","1999","20-24",346,195,151,
"201","1999","25-29",360,183,177,
"201","1999","30-34",445,230,215,
"201","1999","35-39",588,308,280,
"201","1999","40-44",606,325,281,
"201","1999","45-49",606,353,253,
"201","1999","50-54",459,266,193,
"201","1999","55-59",337,196,141,
"201","1999","60-64",249,160,89,
"201","1999","65-69",151,85,66,
"201","1999","70-74",101,60,41,
"201","1999","75-79",73,35,38,
"201","1999","80-84",23,9,14,
"201","1999","85+",20,10,10,
"220","1999","0-4",543,294,249,
"220","1999","5-9",677,342,335,
"220","1999","10-14",713,335,378,
"220","1999","15-19",693,378,315,
"220","1999","20-24",551,302,249,
"220","1999","25-29",562,297,265,
"220","1999","30-34",632,308,324,
"220","1999","35-39",727,382,345,
"220","1999","40-44",827,408,419,
"220","1999","45-49",731,377,354,
"220","1999","50-54",577,302,275,
"220","1999","55-59",379,215,164,
"220","1999","60-64",348,172,176,
"220","1999","65-69",251,126,125,
"220","1999","70-74",183,84,99,
"220","1999","75-79",141,66,75,
"220","1999","80-84",72,29,43,
"220","1999","85+",74,19,55,
"232","1999","0-4",180,93,87,
"232","1999","5-9",279,147,132,
"232","1999","10-14",311,164,147,
"232","1999","15-19",289,149,140,
"232","1999","20-24",184,100,84,
"232","1999","25-29",169,87,82,
"232","1999","30-34",231,140,91,
"232","1999","35-39",322,171,151,
"232","1999","40-44",321,185,136,
"232","1999","45-49",360,173,187,
"232","1999","50-54",292,169,123,
"232","1999","55-59",197,105,92,
"232","1999","60-64",147,91,56,
"232","1999","65-69",89,50,39,
"232","1999","70-74",73,42,31,
"232","1999","75-79",52,25,27,
"232","1999","80-84",20,6,14,
"232","1999","85+",25,8,17,
"240","1999","0-4",414,215,199,
"240","1999","5-9",556,273,283,
"240","1999","10-14",662,323,339,
"240","1999","15-19",572,304,268,
"240","1999","20-24",327,176,151,
"240","1999","25-29",334,161,173,
"240","1999","30-34",358,168,190,
"240","1999","35-39",512,253,259,
"240","1999","40-44",575,289,286,
"240","1999","45-49",550,299,251,
"240","1999","50-54",430,234,196,
"240","1999","55-59",342,193,149,
"240","1999","60-64",278,149,129,
"240","1999","65-69",138,77,61,
"240","1999","70-74",122,64,58,
"240","1999","75-79",55,30,25,
"240","1999","80-84",33,14,19,
"240","1999","85+",25,8,17,
"261","1999","0-4",684,312,372,
"261","1999","5-9",856,463,393,
"261","1999","10-14",994,520,474,
"261","1999","15-19",819,430,389,
"261","1999","20-24",465,276,189,
"261","1999","25-29",550,268,282,
"261","1999","30-34",665,342,323,
"261","1999","35-39",926,481,445,
"261","1999","40-44",1106,559,547,
"261","1999","45-49",1028,564,464,
"261","1999","50-54",797,443,354,
"261","1999","55-59",511,316,195,
"261","1999","60-64",310,173,137,
"261","1999","65-69",218,129,89,
"261","1999","70-74",170,90,80,
"261","1999","75-79",123,52,71,
"261","1999","80-84",53,24,29,
"261","1999","85+",58,32,26,
"270","1999","0-4",755,403,352,
"270","1999","5-9",1008,547,461,
"270","1999","10-14",1021,513,508,
"270","1999","15-19",744,381,363,
"270","1999","20-24",452,212,240,
"270","1999","25-29",456,223,233,
"270","1999","30-34",476,249,227,
"270","1999","35-39",467,247,220,
"270","1999","40-44",414,230,184,
"270","1999","45-49",304,159,145,
"270","1999","50-54",256,143,113,
"270","1999","55-59",189,105,84,
"270","1999","60-64",143,76,67,
"270","1999","65-69",151,68,83,
"270","1999","70-74",92,43,49,
"270","1999","75-79",79,38,41,
"270","1999","80-84",25,13,12,
"270","1999","85+",28,8,20,
"280","1999","0-4",499,266,233,
"280","1999","5-9",585,299,286,
"280","1999","10-14",715,365,350,
"280","1999","15-19",516,280,236,
"280","1999","20-24",291,161,130,
"280","1999","25-29",351,176,175,
"280","1999","30-34",467,242,225,
"280","1999","35-39",563,279,284,
"280","1999","40-44",756,382,374,
"280","1999","45-49",647,368,279,
"280","1999","50-54",494,256,238,
"280","1999","55-59",354,205,149,
"280","1999","60-64",241,139,102,
"280","1999","65-69",183,95,88,
"280","1999","70-74",168,80,88,
"280","1999","75-79",156,77,79,
"280","1999","80-84",82,38,44,
"280","1999","85+",69,24,45,
"282","1999","0-4",33,14,19,
"282","1999","5-9",78,46,32,
"282","1999","10-14",61,35,26,
"282","1999","15-19",55,33,22,
"282","1999","20-24",29,20,9,
"282","1999","25-29",32,11,21,
"282","1999","30-34",59,34,25,
"282","1999","35-39",56,30,26,
"282","1999","40-44",91,68,23,
"282","1999","45-49",75,48,27,
"282","1999","50-54",56,30,26,
"282","1999","55-59",42,34,8,
"282","1999","60-64",21,11,10,
"282","1999","65-69",18,9,9,
"282","1999","70-74",18,11,7,
"282","1999","75-79",4,1,3,
"282","1999","80-84",0,0,0,
"282","1999","85+",1,1,0,
"290","1999","0-4",442,222,220,
"290","1999","5-9",633,339,294,
"290","1999","10-14",769,398,371,
"290","1999","15-19",626,351,275,
"290","1999","20-24",374,234,140,
"290","1999","25-29",314,165,149,
"290","1999","30-34",384,213,171,
"290","1999","35-39",492,253,239,
"290","1999","40-44",533,293,240,
"290","1999","45-49",517,277,240,
"290","1999","50-54",379,204,175,
"290","1999","55-59",260,161,99,
"290","1999","60-64",194,112,82,
"290","1999","65-69",149,66,83,
"290","1999","70-74",150,82,68,
"290","1999","75-79",71,39,32,
"290","1999","80-84",45,25,20,
"290","1999","85+",40,20,20,
"000","2000","0-4",47592,24405,23187,
"000","2000","5-9",53771,27519,26252,
"000","2000","10-14",56661,29078,27583,
"000","2000","15-19",50094,26366,23728,
"000","2000","20-24",39892,21192,18700,
"000","2000","25-29",42987,22186,20801,
"000","2000","30-34",46486,24121,22365,
"000","2000","35-39",55723,28555,27168,
"000","2000","40-44",58325,29798,28527,
"000","2000","45-49",53515,27950,25565,
"000","2000","50-54",41437,22311,19126,
"000","2000","55-59",27423,14698,12725,
"000","2000","60-64",17327,9208,8119,
"000","2000","65-69",12626,6371,6255,
"000","2000","70-74",9881,4862,5019,
"000","2000","75-79",6863,3066,3797,
"000","2000","80-84",3695,1522,2173,
"000","2000","85+",2634,903,1731,
"013","2000","0-4",116,60,56,
"013","2000","5-9",117,61,56,
"013","2000","10-14",131,68,63,
"013","2000","15-19",156,95,61,
"013","2000","20-24",208,136,72,
"013","2000","25-29",190,125,65,
"013","2000","30-34",280,198,82,
"013","2000","35-39",367,269,98,
"013","2000","40-44",303,210,93,
"013","2000","45-49",285,178,107,
"013","2000","50-54",252,164,88,
"013","2000","55-59",141,88,53,
"013","2000","60-64",80,51,29,
"013","2000","65-69",36,24,12,
"013","2000","70-74",15,11,4,
"013","2000","75-79",12,8,4,
"013","2000","80-84",8,4,4,
"013","2000","85+",0,0,0,
"016","2000","0-4",257,129,128,
"016","2000","5-9",248,137,111,
"016","2000","10-14",266,139,127,
"016","2000","15-19",260,139,121,
"016","2000","20-24",336,209,127,
"016","2000","25-29",451,307,144,
"016","2000","30-34",751,529,222,
"016","2000","35-39",726,496,230,
"016","2000","40-44",674,467,207,
"016","2000","45-49",562,370,192,
"016","2000","50-54",460,312,148,
"016","2000","55-59",203,132,71,
"016","2000","60-64",146,87,59,
"016","2000","65-69",58,28,30,
"016","2000","70-74",37,20,17,
"016","2000","75-79",17,10,7,
"016","2000","80-84",6,0,6,
"016","2000","85+",7,2,5,
"020","2000","0-4",20033,10183,9850,
"020","2000","5-9",21867,11154,10713,
"020","2000","10-14",21501,11015,10486,
"020","2000","15-19",19662,10121,9541,
"020","2000","20-24",17694,9178,8516,
"020","2000","25-29",19748,10101,9647,
"020","2000","30-34",20365,10376,9989,
"020","2000","35-39",23972,12024,11948,
"020","2000","40-44",24238,11992,12246,
"020","2000","45-49",21685,11033,10652,
"020","2000","50-54",17118,8896,8222,
"020","2000","55-59",11240,5822,5418,
"020","2000","60-64",6918,3507,3411,
"020","2000","65-69",4982,2398,2584,
"020","2000","70-74",3913,1802,2111,
"020","2000","75-79",2805,1168,1637,
"020","2000","80-84",1479,580,899,
"020","2000","85+",1063,318,745,
"050","2000","0-4",1608,877,731,
"050","2000","5-9",1912,1019,893,
"050","2000","10-14",1893,992,901,
"050","2000","15-19",1469,771,698,
"050","2000","20-24",1065,551,514,
"050","2000","25-29",1022,525,497,
"050","2000","30-34",1137,610,527,
"050","2000","35-39",1314,702,612,
"050","2000","40-44",1158,618,540,
"050","2000","45-49",968,535,433,
"050","2000","50-54",737,422,315,
"050","2000","55-59",601,321,280,
"050","2000","60-64",327,165,162,
"050","2000","65-69",302,141,161,
"050","2000","70-74",217,123,94,
"050","2000","75-79",145,78,67,
"050","2000","80-84",106,47,59,
"050","2000","85+",66,28,38,
"060","2000","0-4",89,47,42,
"060","2000","5-9",107,49,58,
"060","2000","10-14",129,72,57,
"060","2000","15-19",99,47,52,
"060","2000","20-24",44,26,18,
"060","2000","25-29",64,35,29,
"060","2000","30-34",79,43,36,
"060","2000","35-39",135,71,64,
"060","2000","40-44",160,93,67,
"060","2000","45-49",122,65,57,
"060","2000","50-54",93,55,38,
"060","2000","55-59",49,31,18,
"060","2000","60-64",40,22,18,
"060","2000","65-69",22,12,10,
"060","2000","70-74",13,11,2,
"060","2000","75-79",7,3,4,
"060","2000","80-84",4,3,1,
"060","2000","85+",2,0,2,
"068","2000","0-4",98,53,45,
"068","2000","5-9",109,62,47,
"068","2000","10-14",151,84,67,
"068","2000","15-19",127,66,61,
"068","2000","20-24",92,56,36,
"068","2000","25-29",131,74,57,
"068","2000","30-34",140,88,52,
"068","2000","35-39",181,101,80,
"068","2000","40-44",244,141,103,
"068","2000","45-49",232,134,98,
"068","2000","50-54",159,100,59,
"068","2000","55-59",107,68,39,
"068","2000","60-64",64,40,24,
"068","2000","65-69",29,20,9,
"068","2000","70-74",12,7,5,
"068","2000","75-79",6,4,2,
"068","2000","80-84",3,3,0,
"068","2000","85+",8,0,8,
"070","2000","0-4",476,246,230,
"070","2000","5-9",521,289,232,
"070","2000","10-14",603,303,300,
"070","2000","15-19",402,218,184,
"070","2000","20-24",255,133,122,
"070","2000","25-29",249,121,128,
"070","2000","30-34",345,176,169,
"070","2000","35-39",436,241,195,
"070","2000","40-44",392,196,196,
"070","2000","45-49",375,200,175,
"070","2000","50-54",252,125,127,
"070","2000","55-59",206,107,99,
"070","2000","60-64",128,67,61,
"070","2000","65-69",95,51,44,
"070","2000","70-74",88,45,43,
"070","2000","75-79",48,24,24,
"070","2000","80-84",28,13,15,
"070","2000","85+",23,12,11,
"090","2000","0-4",6722,3410,3312,
"090","2000","5-9",7006,3549,3457,
"090","2000","10-14",7189,3672,3517,
"090","2000","15-19",6685,3618,3067,
"090","2000","20-24",7416,4094,3322,
"090","2000","25-29",7063,3791,3272,
"090","2000","30-34",6466,3383,3083,
"090","2000","35-39",7062,3591,3471,
"090","2000","40-44",6990,3483,3507,
"090","2000","45-49",6433,3353,3080,
"090","2000","50-54",4968,2727,2241,
"090","2000","55-59",3096,1674,1422,
"090","2000","60-64",1899,1029,870,
"090","2000","65-69",1356,690,666,
"090","2000","70-74",1043,529,514,
"090","2000","75-79",736,323,413,
"090","2000","80-84",433,181,252,
"090","2000","85+",277,120,157,
"100","2000","0-4",128,62,66,
"100","2000","5-9",157,78,79,
"100","2000","10-14",201,100,101,
"100","2000","15-19",167,89,78,
"100","2000","20-24",87,43,44,
"100","2000","25-29",96,43,53,
"100","2000","30-34",145,73,72,
"100","2000","35-39",185,87,98,
"100","2000","40-44",248,127,121,
"100","2000","45-49",253,139,114,
"100","2000","50-54",238,124,114,
"100","2000","55-59",146,69,77,
"100","2000","60-64",91,44,47,
"100","2000","65-69",87,45,42,
"100","2000","70-74",61,39,22,
"100","2000","75-79",50,25,25,
"100","2000","80-84",28,12,16,
"100","2000","85+",24,12,12,
"110","2000","0-4",2003,1022,981,
"110","2000","5-9",2339,1180,1159,
"110","2000","10-14",2541,1298,1243,
"110","2000","15-19",2321,1213,1108,
"110","2000","20-24",1686,826,860,
"110","2000","25-29",1929,960,969,
"110","2000","30-34",2357,1213,1144,
"110","2000","35-39",2788,1382,1406,
"110","2000","40-44",2993,1484,1509,
"110","2000","45-49",3041,1530,1511,
"110","2000","50-54",2473,1302,1171,
"110","2000","55-59",1456,745,711,
"110","2000","60-64",916,490,426,
"110","2000","65-69",580,293,287,
"110","2000","70-74",504,230,274,
"110","2000","75-79",367,148,219,
"110","2000","80-84",248,93,155,
"110","2000","85+",169,60,109,
"122","2000","0-4",3288,1665,1623,
"122","2000","5-9",4024,2084,1940,
"122","2000","10-14",4698,2372,2326,
"122","2000","15-19",4140,2219,1921,
"122","2000","20-24",2132,1179,953,
"122","2000","25-29",2627,1368,1259,
"122","2000","30-34",3021,1526,1495,
"122","2000","35-39",4140,2139,2001,
"122","2000","40-44",4934,2547,2387,
"122","2000","45-49",5008,2619,2389,
"122","2000","50-54",3731,2036,1695,
"122","2000","55-59",2632,1432,1200,
"122","2000","60-64",1667,902,765,
"122","2000","65-69",1310,676,634,
"122","2000","70-74",1051,531,520,
"122","2000","75-79",736,351,385,
"122","2000","80-84",341,130,211,
"122","2000","85+",211,77,134,
"130","2000","0-4",953,485,468,
"130","2000","5-9",1145,588,557,
"130","2000","10-14",1177,596,581,
"130","2000","15-19",1044,536,508,
"130","2000","20-24",692,350,342,
"130","2000","25-29",779,376,403,
"130","2000","30-34",1005,500,505,
"130","2000","35-39",1278,687,591,
"130","2000","40-44",1351,681,670,
"130","2000","45-49",1214,626,588,
"130","2000","50-54",1083,576,507,
"130","2000","55-59",746,398,348,
"130","2000","60-64",483,282,201,
"130","2000","65-69",332,162,170,
"130","2000","70-74",308,152,156,
"130","2000","75-79",225,93,132,
"130","2000","80-84",137,63,74,
"130","2000","85+",107,31,76,
"150","2000","0-4",1245,629,616,
"150","2000","5-9",1269,628,641,
"150","2000","10-14",1314,682,632,
"150","2000","15-19",1027,534,493,
"150","2000","20-24",817,445,372,
"150","2000","25-29",897,478,419,
"150","2000","30-34",1165,629,536,
"150","2000","35-39",1390,734,656,
"150","2000","40-44",1272,707,565,
"150","2000","45-49",1134,612,522,
"150","2000","50-54",850,467,383,
"150","2000","55-59",529,282,247,
"150","2000","60-64",331,177,154,
"150","2000","65-69",272,151,121,
"150","2000","70-74",177,91,86,
"150","2000","75-79",110,59,51,
"150","2000","80-84",70,36,34,
"150","2000","85+",44,21,23,
"164","2000","0-4",145,65,80,
"164","2000","5-9",200,104,96,
"164","2000","10-14",217,108,109,
"164","2000","15-19",190,104,86,
"164","2000","20-24",92,47,45,
"164","2000","25-29",77,38,39,
"164","2000","30-34",98,51,47,
"164","2000","35-39",157,90,67,
"164","2000","40-44",179,100,79,
"164","2000","45-49",137,70,67,
"164","2000","50-54",91,53,38,
"164","2000","55-59",86,48,38,
"164","2000","60-64",55,36,19,
"164","2000","65-69",39,22,17,
"164","2000","70-74",26,18,8,
"164","2000","75-79",18,11,7,
"164","2000","80-84",10,3,7,
"164","2000","85+",6,1,5,
"170","2000","0-4",4147,2141,2006,
"170","2000","5-9",5202,2620,2582,
"170","2000","10-14",6034,3153,2881,
"170","2000","15-19",5317,2873,2444,
"170","2000","20-24",2816,1496,1320,
"170","2000","25-29",3086,1524,1562,
"170","2000","30-34",3841,1918,1923,
"170","2000","35-39",5288,2618,2670,
"170","2000","40-44",6233,3265,2968,
"170","2000","45-49",5659,2956,2703,
"170","2000","50-54",3825,2093,1732,
"170","2000","55-59",2650,1484,1166,
"170","2000","60-64",1724,937,787,
"170","2000","65-69",1360,704,656,
"170","2000","70-74",991,531,460,
"170","2000","75-79",634,310,324,
"170","2000","80-84",317,141,176,
"170","2000","85+",198,67,131,
"180","2000","0-4",790,431,359,
"180","2000","5-9",1021,534,487,
"180","2000","10-14",1029,530,499,
"180","2000","15-19",841,443,398,
"180","2000","20-24",594,320,274,
"180","2000","25-29",610,310,300,
"180","2000","30-34",616,349,267,
"180","2000","35-39",732,417,315,
"180","2000","40-44",712,391,321,
"180","2000","45-49",644,364,280,
"180","2000","50-54",490,305,185,
"180","2000","55-59",348,185,163,
"180","2000","60-64",229,128,101,
"180","2000","65-69",173,98,75,
"180","2000","70-74",149,69,80,
"180","2000","75-79",98,50,48,
"180","2000","80-84",57,26,31,
"180","2000","85+",63,19,44,
"185","2000","0-4",705,397,308,
"185","2000","5-9",782,383,399,
"185","2000","10-14",863,457,406,
"185","2000","15-19",721,379,342,
"185","2000","20-24",448,221,227,
"185","2000","25-29",459,247,212,
"185","2000","30-34",530,284,246,
"185","2000","35-39",597,318,279,
"185","2000","40-44",636,340,296,
"185","2000","45-49",507,288,219,
"185","2000","50-54",390,220,170,
"185","2000","55-59",266,145,121,
"185","2000","60-64",173,95,78,
"185","2000","65-69",119,63,56,
"185","2000","70-74",82,39,43,
"185","2000","75-79",58,18,40,
"185","2000","80-84",32,11,21,
"185","2000","85+",17,5,12,
"188","2000","0-4",773,403,370,
"188","2000","5-9",827,433,394,
"188","2000","10-14",910,461,449,
"188","2000","15-19",711,360,351,
"188","2000","20-24",487,255,232,
"188","2000","25-29",490,259,231,
"188","2000","30-34",521,299,222,
"188","2000","35-39",530,286,244,
"188","2000","40-44",484,281,203,
"188","2000","45-49",424,247,177,
"188","2000","50-54",331,190,141,
"188","2000","55-59",215,118,97,
"188","2000","60-64",146,87,59,
"188","2000","65-69",139,64,75,
"188","2000","70-74",108,52,56,
"188","2000","75-79",57,24,33,
"188","2000","80-84",28,18,10,
"188","2000","85+",27,10,17,
"201","2000","0-4",464,243,221,
"201","2000","5-9",506,270,236,
"201","2000","10-14",567,285,282,
"201","2000","15-19",525,284,241,
"201","2000","20-24",310,176,134,
"201","2000","25-29",343,173,170,
"201","2000","30-34",391,201,190,
"201","2000","35-39",526,271,255,
"201","2000","40-44",589,325,264,
"201","2000","45-49",583,335,248,
"201","2000","50-54",438,255,183,
"201","2000","55-59",344,202,142,
"201","2000","60-64",221,134,87,
"201","2000","65-69",144,93,51,
"201","2000","70-74",99,57,42,
"201","2000","75-79",68,35,33,
"201","2000","80-84",21,7,14,
"201","2000","85+",18,10,8,
"220","2000","0-4",565,318,247,
"220","2000","5-9",669,326,343,
"220","2000","10-14",730,348,382,
"220","2000","15-19",689,377,312,
"220","2000","20-24",573,308,265,
"220","2000","25-29",533,262,271,
"220","2000","30-34",626,318,308,
"220","2000","35-39",729,376,353,
"220","2000","40-44",844,419,425,
"220","2000","45-49",774,395,379,
"220","2000","50-54",592,310,282,
"220","2000","55-59",415,228,187,
"220","2000","60-64",352,182,170,
"220","2000","65-69",261,127,134,
"220","2000","70-74",194,103,91,
"220","2000","75-79",144,64,80,
"220","2000","80-84",67,24,43,
"220","2000","85+",78,20,58,
"232","2000","0-4",178,88,90,
"232","2000","5-9",269,147,122,
"232","2000","10-14",284,138,146,
"232","2000","15-19",263,139,124,
"232","2000","20-24",171,89,82,
"232","2000","25-29",184,96,88,
"232","2000","30-34",215,131,84,
"232","2000","35-39",300,155,145,
"232","2000","40-44",314,176,138,
"232","2000","45-49",344,186,158,
"232","2000","50-54",305,170,135,
"232","2000","55-59",206,110,96,
"232","2000","60-64",151,89,62,
"232","2000","65-69",90,61,29,
"232","2000","70-74",66,32,34,
"232","2000","75-79",50,25,25,
"232","2000","80-84",24,10,14,
"232","2000","85+",22,6,16,
"240","2000","0-4",438,225,213,
"240","2000","5-9",539,274,265,
"240","2000","10-14",656,313,343,
"240","2000","15-19",565,314,251,
"240","2000","20-24",297,164,133,
"240","2000","25-29",328,160,168,
"240","2000","30-34",358,173,185,
"240","2000","35-39",478,236,242,
"240","2000","40-44",553,284,269,
"240","2000","45-49",541,284,257,
"240","2000","50-54",444,240,204,
"240","2000","55-59",340,190,150,
"240","2000","60-64",262,146,116,
"240","2000","65-69",150,82,68,
"240","2000","70-74",118,59,59,
"240","2000","75-79",53,31,22,
"240","2000","80-84",35,13,22,
"240","2000","85+",19,6,13,
"261","2000","0-4",679,331,348,
"261","2000","5-9",799,431,368,
"261","2000","10-14",994,531,463,
"261","2000","15-19",784,408,376,
"261","2000","20-24",477,283,194,
"261","2000","25-29",500,229,271,
"261","2000","30-34",669,346,323,
"261","2000","35-39",895,478,417,
"261","2000","40-44",1084,550,534,
"261","2000","45-49",1028,567,461,
"261","2000","50-54",857,474,383,
"261","2000","55-59",506,306,200,
"261","2000","60-64",309,173,136,
"261","2000","65-69",206,117,89,
"261","2000","70-74",187,99,88,
"261","2000","75-79",117,53,64,
"261","2000","80-84",55,27,28,
"261","2000","85+",49,25,24,
"270","2000","0-4",744,401,343,
"270","2000","5-9",953,509,444,
"270","2000","10-14",1063,553,510,
"270","2000","15-19",754,381,373,
"270","2000","20-24",441,217,224,
"270","2000","25-29",447,223,224,
"270","2000","30-34",486,249,237,
"270","2000","35-39",438,233,205,
"270","2000","40-44",430,235,195,
"270","2000","45-49",308,164,144,
"270","2000","50-54",270,154,116,
"270","2000","55-59",196,105,91,
"270","2000","60-64",146,74,72,
"270","2000","65-69",138,68,70,
"270","2000","70-74",90,40,50,
"270","2000","75-79",78,42,36,
"270","2000","80-84",25,12,13,
"270","2000","85+",21,6,15,
"280","2000","0-4",445,238,207,
"280","2000","5-9",512,257,255,
"280","2000","10-14",666,348,318,
"280","2000","15-19",479,258,221,
"280","2000","20-24",267,143,124,
"280","2000","25-29",321,164,157,
"280","2000","30-34",450,230,220,
"280","2000","35-39",494,246,248,
"280","2000","40-44",675,333,342,
"280","2000","45-49",629,347,282,
"280","2000","50-54",507,269,238,
"280","2000","55-59",358,199,159,
"280","2000","60-64",247,141,106,
"280","2000","65-69",163,87,76,
"280","2000","70-74",173,86,87,
"280","2000","75-79",140,65,75,
"280","2000","80-84",85,40,45,
"280","2000","85+",73,26,47,
"282","2000","0-4",39,18,21,
"282","2000","5-9",79,46,33,
"282","2000","10-14",66,32,34,
"282","2000","15-19",60,37,23,
"282","2000","20-24",26,14,12,
"282","2000","25-29",35,17,18,
"282","2000","30-34",59,31,28,
"282","2000","35-39",80,49,31,
"282","2000","40-44",89,59,30,
"282","2000","45-49",94,62,32,
"282","2000","50-54",69,41,28,
"282","2000","55-59",40,31,9,
"282","2000","60-64",29,18,11,
"282","2000","65-69",18,10,8,
"282","2000","70-74",14,8,6,
"282","2000","75-79",10,5,5,
"282","2000","80-84",0,0,0,
"282","2000","85+",1,1,0,
"290","2000","0-4",464,238,226,
"290","2000","5-9",592,307,285,
"290","2000","10-14",788,428,360,
"290","2000","15-19",636,343,293,
"290","2000","20-24",369,233,136,
"290","2000","25-29",328,180,148,
"290","2000","30-34",370,197,173,
"290","2000","35-39",505,258,247,
"290","2000","40-44",546,294,252,
"290","2000","45-49",531,291,240,
"290","2000","50-54",414,231,183,
"290","2000","55-59",301,178,123,
"290","2000","60-64",193,105,88,
"290","2000","65-69",165,84,81,
"290","2000","70-74",145,78,67,
"290","2000","75-79",74,39,35,
"290","2000","80-84",48,25,23,
"290","2000","85+",41,20,21,
