"Borough/Census Area FIPS","Year","Age","Total","Male","Female","Data from: https://web.archive.org/web/20210611231927/https://live.laborstats.alaska.gov/pop/estimates/data/AgeBySexBCA_2000to2010.xls via https://web.archive.org/web/20210611231927/https://live.laborstats.alaska.gov/pop/index.cfm March 2023 "
"000",2000,"0-4",47592,24405,23187,
"000",2000,"5-9",53771,27519,26252,
"000",2000,"10-14",56661,29078,27583,
"000",2000,"15-19",50094,26366,23728,
"000",2000,"20-24",39892,21192,18700,
"000",2000,"25-29",42987,22186,20801,
"000",2000,"30-34",46486,24121,22365,
"000",2000,"35-39",55723,28555,27168,
"000",2000,"40-44",58325,29798,28527,
"000",2000,"45-49",53515,27950,25565,
"000",2000,"50-54",41437,22311,19126,
"000",2000,"55-59",27423,14698,12725,
"000",2000,"60-64",17327,9208,8119,
"000",2000,"65-69",12626,6371,6255,
"000",2000,"70-74",9881,4862,5019,
"000",2000,"75-79",6863,3066,3797,
"000",2000,"80-84",3695,1522,2173,
"000",2000,"85+",2634,903,1731,
"013",2000,"0-4",116,60,56,
"013",2000,"5-9",117,61,56,
"013",2000,"10-14",131,68,63,
"013",2000,"15-19",156,95,61,
"013",2000,"20-24",208,136,72,
"013",2000,"25-29",190,125,65,
"013",2000,"30-34",280,198,82,
"013",2000,"35-39",367,269,98,
"013",2000,"40-44",303,210,93,
"013",2000,"45-49",285,178,107,
"013",2000,"50-54",252,164,88,
"013",2000,"55-59",141,88,53,
"013",2000,"60-64",80,51,29,
"013",2000,"65-69",36,24,12,
"013",2000,"70-74",15,11,4,
"013",2000,"75-79",12,8,4,
"013",2000,"80-84",8,4,4,
"013",2000,"85+",0,0,0,
"016",2000,"0-4",257,129,128,
"016",2000,"5-9",248,137,111,
"016",2000,"10-14",266,139,127,
"016",2000,"15-19",260,139,121,
"016",2000,"20-24",336,209,127,
"016",2000,"25-29",451,307,144,
"016",2000,"30-34",751,529,222,
"016",2000,"35-39",726,496,230,
"016",2000,"40-44",674,467,207,
"016",2000,"45-49",562,370,192,
"016",2000,"50-54",460,312,148,
"016",2000,"55-59",203,132,71,
"016",2000,"60-64",146,87,59,
"016",2000,"65-69",58,28,30,
"016",2000,"70-74",37,20,17,
"016",2000,"75-79",17,10,7,
"016",2000,"80-84",6,0,6,
"016",2000,"85+",7,2,5,
"020",2000,"0-4",20033,10183,9850,
"020",2000,"5-9",21867,11154,10713,
"020",2000,"10-14",21501,11015,10486,
"020",2000,"15-19",19662,10121,9541,
"020",2000,"20-24",17694,9178,8516,
"020",2000,"25-29",19748,10101,9647,
"020",2000,"30-34",20365,10376,9989,
"020",2000,"35-39",23972,12024,11948,
"020",2000,"40-44",24238,11992,12246,
"020",2000,"45-49",21685,11033,10652,
"020",2000,"50-54",17118,8896,8222,
"020",2000,"55-59",11240,5822,5418,
"020",2000,"60-64",6918,3507,3411,
"020",2000,"65-69",4982,2398,2584,
"020",2000,"70-74",3913,1802,2111,
"020",2000,"75-79",2805,1168,1637,
"020",2000,"80-84",1479,580,899,
"020",2000,"85+",1063,318,745,
"050",2000,"0-4",1608,877,731,
"050",2000,"5-9",1912,1019,893,
"050",2000,"10-14",1893,992,901,
"050",2000,"15-19",1469,771,698,
"050",2000,"20-24",1065,551,514,
"050",2000,"25-29",1022,525,497,
"050",2000,"30-34",1137,610,527,
"050",2000,"35-39",1314,702,612,
"050",2000,"40-44",1158,618,540,
"050",2000,"45-49",968,535,433,
"050",2000,"50-54",737,422,315,
"050",2000,"55-59",601,321,280,
"050",2000,"60-64",327,165,162,
"050",2000,"65-69",302,141,161,
"050",2000,"70-74",217,123,94,
"050",2000,"75-79",145,78,67,
"050",2000,"80-84",106,47,59,
"050",2000,"85+",66,28,38,
"060",2000,"0-4",89,47,42,
"060",2000,"5-9",107,49,58,
"060",2000,"10-14",129,72,57,
"060",2000,"15-19",99,47,52,
"060",2000,"20-24",44,26,18,
"060",2000,"25-29",64,35,29,
"060",2000,"30-34",79,43,36,
"060",2000,"35-39",135,71,64,
"060",2000,"40-44",160,93,67,
"060",2000,"45-49",122,65,57,
"060",2000,"50-54",93,55,38,
"060",2000,"55-59",49,31,18,
"060",2000,"60-64",40,22,18,
"060",2000,"65-69",22,12,10,
"060",2000,"70-74",13,11,2,
"060",2000,"75-79",7,3,4,
"060",2000,"80-84",4,3,1,
"060",2000,"85+",2,0,2,
"068",2000,"0-4",98,53,45,
"068",2000,"5-9",109,62,47,
"068",2000,"10-14",151,84,67,
"068",2000,"15-19",127,66,61,
"068",2000,"20-24",92,56,36,
"068",2000,"25-29",131,74,57,
"068",2000,"30-34",140,88,52,
"068",2000,"35-39",181,101,80,
"068",2000,"40-44",244,141,103,
"068",2000,"45-49",232,134,98,
"068",2000,"50-54",159,100,59,
"068",2000,"55-59",107,68,39,
"068",2000,"60-64",64,40,24,
"068",2000,"65-69",29,20,9,
"068",2000,"70-74",12,7,5,
"068",2000,"75-79",6,4,2,
"068",2000,"80-84",3,3,0,
"068",2000,"85+",8,0,8,
"070",2000,"0-4",476,246,230,
"070",2000,"5-9",521,289,232,
"070",2000,"10-14",603,303,300,
"070",2000,"15-19",402,218,184,
"070",2000,"20-24",255,133,122,
"070",2000,"25-29",249,121,128,
"070",2000,"30-34",345,176,169,
"070",2000,"35-39",436,241,195,
"070",2000,"40-44",392,196,196,
"070",2000,"45-49",375,200,175,
"070",2000,"50-54",252,125,127,
"070",2000,"55-59",206,107,99,
"070",2000,"60-64",128,67,61,
"070",2000,"65-69",95,51,44,
"070",2000,"70-74",88,45,43,
"070",2000,"75-79",48,24,24,
"070",2000,"80-84",28,13,15,
"070",2000,"85+",23,12,11,
"090",2000,"0-4",6722,3410,3312,
"090",2000,"5-9",7006,3549,3457,
"090",2000,"10-14",7189,3672,3517,
"090",2000,"15-19",6685,3618,3067,
"090",2000,"20-24",7416,4094,3322,
"090",2000,"25-29",7063,3791,3272,
"090",2000,"30-34",6466,3383,3083,
"090",2000,"35-39",7062,3591,3471,
"090",2000,"40-44",6990,3483,3507,
"090",2000,"45-49",6433,3353,3080,
"090",2000,"50-54",4968,2727,2241,
"090",2000,"55-59",3096,1674,1422,
"090",2000,"60-64",1899,1029,870,
"090",2000,"65-69",1356,690,666,
"090",2000,"70-74",1043,529,514,
"090",2000,"75-79",736,323,413,
"090",2000,"80-84",433,181,252,
"090",2000,"85+",277,120,157,
"100",2000,"0-4",128,62,66,
"100",2000,"5-9",157,78,79,
"100",2000,"10-14",201,100,101,
"100",2000,"15-19",167,89,78,
"100",2000,"20-24",87,43,44,
"100",2000,"25-29",96,43,53,
"100",2000,"30-34",145,73,72,
"100",2000,"35-39",185,87,98,
"100",2000,"40-44",248,127,121,
"100",2000,"45-49",253,139,114,
"100",2000,"50-54",238,124,114,
"100",2000,"55-59",146,69,77,
"100",2000,"60-64",91,44,47,
"100",2000,"65-69",87,45,42,
"100",2000,"70-74",61,39,22,
"100",2000,"75-79",50,25,25,
"100",2000,"80-84",28,12,16,
"100",2000,"85+",24,12,12,
"105",2000,"0-4",138,70,68,
"105",2000,"5-9",204,118,86,
"105",2000,"10-14",240,114,126,
"105",2000,"15-19",229,121,108,
"105",2000,"20-24",132,67,65,
"105",2000,"25-29",112,62,50,
"105",2000,"30-34",139,89,50,
"105",2000,"35-39",226,114,112,
"105",2000,"40-44",238,134,104,
"105",2000,"45-49",246,125,121,
"105",2000,"50-54",226,130,96,
"105",2000,"55-59",147,86,61,
"105",2000,"60-64",118,69,49,
"105",2000,"65-69",67,48,19,
"105",2000,"70-74",44,22,22,
"105",2000,"75-79",35,19,16,
"105",2000,"80-84",17,5,12,
"105",2000,"85+",16,5,11,
"110",2000,"0-4",2003,1022,981,
"110",2000,"5-9",2339,1180,1159,
"110",2000,"10-14",2541,1298,1243,
"110",2000,"15-19",2321,1213,1108,
"110",2000,"20-24",1686,826,860,
"110",2000,"25-29",1929,960,969,
"110",2000,"30-34",2357,1213,1144,
"110",2000,"35-39",2788,1382,1406,
"110",2000,"40-44",2993,1484,1509,
"110",2000,"45-49",3041,1530,1511,
"110",2000,"50-54",2473,1302,1171,
"110",2000,"55-59",1456,745,711,
"110",2000,"60-64",916,490,426,
"110",2000,"65-69",580,293,287,
"110",2000,"70-74",504,230,274,
"110",2000,"75-79",367,148,219,
"110",2000,"80-84",248,93,155,
"110",2000,"85+",169,60,109,
"122",2000,"0-4",3288,1665,1623,
"122",2000,"5-9",4024,2084,1940,
"122",2000,"10-14",4698,2372,2326,
"122",2000,"15-19",4140,2219,1921,
"122",2000,"20-24",2132,1179,953,
"122",2000,"25-29",2627,1368,1259,
"122",2000,"30-34",3021,1526,1495,
"122",2000,"35-39",4140,2139,2001,
"122",2000,"40-44",4934,2547,2387,
"122",2000,"45-49",5008,2619,2389,
"122",2000,"50-54",3731,2036,1695,
"122",2000,"55-59",2632,1432,1200,
"122",2000,"60-64",1667,902,765,
"122",2000,"65-69",1310,676,634,
"122",2000,"70-74",1051,531,520,
"122",2000,"75-79",736,351,385,
"122",2000,"80-84",341,130,211,
"122",2000,"85+",211,77,134,
"130",2000,"0-4",965,490,475,
"130",2000,"5-9",1145,588,557,
"130",2000,"10-14",1177,596,581,
"130",2000,"15-19",1045,536,509,
"130",2000,"20-24",691,349,342,
"130",2000,"25-29",781,377,404,
"130",2000,"30-34",1005,500,505,
"130",2000,"35-39",1278,686,592,
"130",2000,"40-44",1348,678,670,
"130",2000,"45-49",1211,624,587,
"130",2000,"50-54",1080,573,507,
"130",2000,"55-59",749,400,349,
"130",2000,"60-64",483,282,201,
"130",2000,"65-69",332,162,170,
"130",2000,"70-74",308,152,156,
"130",2000,"75-79",225,93,132,
"130",2000,"80-84",137,63,74,
"130",2000,"85+",107,33,74,
"150",2000,"0-4",1245,629,616,
"150",2000,"5-9",1269,628,641,
"150",2000,"10-14",1314,682,632,
"150",2000,"15-19",1027,534,493,
"150",2000,"20-24",817,445,372,
"150",2000,"25-29",897,478,419,
"150",2000,"30-34",1165,629,536,
"150",2000,"35-39",1390,734,656,
"150",2000,"40-44",1272,707,565,
"150",2000,"45-49",1134,612,522,
"150",2000,"50-54",850,467,383,
"150",2000,"55-59",529,282,247,
"150",2000,"60-64",331,177,154,
"150",2000,"65-69",272,151,121,
"150",2000,"70-74",177,91,86,
"150",2000,"75-79",110,59,51,
"150",2000,"80-84",70,36,34,
"150",2000,"85+",44,21,23,
"164",2000,"0-4",145,65,80,
"164",2000,"5-9",200,104,96,
"164",2000,"10-14",217,108,109,
"164",2000,"15-19",190,104,86,
"164",2000,"20-24",92,47,45,
"164",2000,"25-29",77,38,39,
"164",2000,"30-34",98,51,47,
"164",2000,"35-39",157,90,67,
"164",2000,"40-44",179,100,79,
"164",2000,"45-49",137,70,67,
"164",2000,"50-54",91,53,38,
"164",2000,"55-59",86,48,38,
"164",2000,"60-64",55,36,19,
"164",2000,"65-69",39,22,17,
"164",2000,"70-74",26,18,8,
"164",2000,"75-79",18,11,7,
"164",2000,"80-84",10,3,7,
"164",2000,"85+",6,1,5,
"170",2000,"0-4",4147,2141,2006,
"170",2000,"5-9",5202,2620,2582,
"170",2000,"10-14",6034,3153,2881,
"170",2000,"15-19",5317,2873,2444,
"170",2000,"20-24",2816,1496,1320,
"170",2000,"25-29",3086,1524,1562,
"170",2000,"30-34",3841,1918,1923,
"170",2000,"35-39",5288,2618,2670,
"170",2000,"40-44",6233,3265,2968,
"170",2000,"45-49",5659,2956,2703,
"170",2000,"50-54",3825,2093,1732,
"170",2000,"55-59",2650,1484,1166,
"170",2000,"60-64",1724,937,787,
"170",2000,"65-69",1360,704,656,
"170",2000,"70-74",991,531,460,
"170",2000,"75-79",634,310,324,
"170",2000,"80-84",317,141,176,
"170",2000,"85+",198,67,131,
"180",2000,"0-4",790,431,359,
"180",2000,"5-9",1021,534,487,
"180",2000,"10-14",1029,530,499,
"180",2000,"15-19",841,443,398,
"180",2000,"20-24",594,320,274,
"180",2000,"25-29",610,310,300,
"180",2000,"30-34",616,349,267,
"180",2000,"35-39",732,417,315,
"180",2000,"40-44",712,391,321,
"180",2000,"45-49",644,364,280,
"180",2000,"50-54",490,305,185,
"180",2000,"55-59",348,185,163,
"180",2000,"60-64",229,128,101,
"180",2000,"65-69",173,98,75,
"180",2000,"70-74",149,69,80,
"180",2000,"75-79",98,50,48,
"180",2000,"80-84",57,26,31,
"180",2000,"85+",63,19,44,
"185",2000,"0-4",705,397,308,
"185",2000,"5-9",782,383,399,
"185",2000,"10-14",863,457,406,
"185",2000,"15-19",721,379,342,
"185",2000,"20-24",448,221,227,
"185",2000,"25-29",459,247,212,
"185",2000,"30-34",530,284,246,
"185",2000,"35-39",597,318,279,
"185",2000,"40-44",636,340,296,
"185",2000,"45-49",507,288,219,
"185",2000,"50-54",390,220,170,
"185",2000,"55-59",266,145,121,
"185",2000,"60-64",173,95,78,
"185",2000,"65-69",119,63,56,
"185",2000,"70-74",82,39,43,
"185",2000,"75-79",58,18,40,
"185",2000,"80-84",32,11,21,
"185",2000,"85+",17,5,12,
"188",2000,"0-4",773,403,370,
"188",2000,"5-9",827,433,394,
"188",2000,"10-14",910,461,449,
"188",2000,"15-19",711,360,351,
"188",2000,"20-24",487,255,232,
"188",2000,"25-29",490,259,231,
"188",2000,"30-34",521,299,222,
"188",2000,"35-39",530,286,244,
"188",2000,"40-44",484,281,203,
"188",2000,"45-49",424,247,177,
"188",2000,"50-54",331,190,141,
"188",2000,"55-59",215,118,97,
"188",2000,"60-64",146,87,59,
"188",2000,"65-69",139,64,75,
"188",2000,"70-74",108,52,56,
"188",2000,"75-79",57,24,33,
"188",2000,"80-84",28,18,10,
"188",2000,"85+",27,10,17,
"195",2000,"0-4",298,159,139,
"195",2000,"5-9",332,164,168,
"195",2000,"10-14",425,217,208,
"195",2000,"15-19",309,169,140,
"195",2000,"20-24",183,96,87,
"195",2000,"25-29",223,118,105,
"195",2000,"30-34",318,171,147,
"195",2000,"35-39",318,162,156,
"195",2000,"40-44",427,208,219,
"195",2000,"45-49",395,219,176,
"195",2000,"50-54",330,178,152,
"195",2000,"55-59",218,124,94,
"195",2000,"60-64",130,72,58,
"195",2000,"65-69",83,44,39,
"195",2000,"70-74",98,48,50,
"195",2000,"75-79",91,43,48,
"195",2000,"80-84",44,20,24,
"195",2000,"85+",38,17,21,
"198",2000,"0-4",451,237,214,
"198",2000,"5-9",505,269,236,
"198",2000,"10-14",567,285,282,
"198",2000,"15-19",524,284,240,
"198",2000,"20-24",311,177,134,
"198",2000,"25-29",338,172,166,
"198",2000,"30-34",388,199,189,
"198",2000,"35-39",526,272,254,
"198",2000,"40-44",592,328,264,
"198",2000,"45-49",583,336,247,
"198",2000,"50-54",436,255,181,
"198",2000,"55-59",339,199,140,
"198",2000,"60-64",216,131,85,
"198",2000,"65-69",143,92,51,
"198",2000,"70-74",99,57,42,
"198",2000,"75-79",68,35,33,
"198",2000,"80-84",21,7,14,
"198",2000,"85+",18,9,9,
"220",2000,"0-4",565,318,247,
"220",2000,"5-9",669,326,343,
"220",2000,"10-14",730,348,382,
"220",2000,"15-19",689,377,312,
"220",2000,"20-24",573,308,265,
"220",2000,"25-29",533,262,271,
"220",2000,"30-34",626,318,308,
"220",2000,"35-39",729,376,353,
"220",2000,"40-44",844,419,425,
"220",2000,"45-49",774,395,379,
"220",2000,"50-54",592,310,282,
"220",2000,"55-59",415,228,187,
"220",2000,"60-64",352,182,170,
"220",2000,"65-69",261,127,134,
"220",2000,"70-74",194,103,91,
"220",2000,"75-79",144,64,80,
"220",2000,"80-84",67,24,43,
"220",2000,"85+",78,20,58,
"230",2000,"0-4",40,18,22,
"230",2000,"5-9",65,29,36,
"230",2000,"10-14",44,24,20,
"230",2000,"15-19",34,18,16,
"230",2000,"20-24",39,22,17,
"230",2000,"25-29",72,34,38,
"230",2000,"30-34",76,42,34,
"230",2000,"35-39",74,41,33,
"230",2000,"40-44",76,42,34,
"230",2000,"45-49",98,61,37,
"230",2000,"50-54",79,40,39,
"230",2000,"55-59",59,24,35,
"230",2000,"60-64",33,20,13,
"230",2000,"65-69",23,13,10,
"230",2000,"70-74",22,10,12,
"230",2000,"75-79",15,6,9,
"230",2000,"80-84",7,5,2,
"230",2000,"85+",6,1,5,
"240",2000,"0-4",438,225,213,
"240",2000,"5-9",539,274,265,
"240",2000,"10-14",656,313,343,
"240",2000,"15-19",565,314,251,
"240",2000,"20-24",297,164,133,
"240",2000,"25-29",328,160,168,
"240",2000,"30-34",358,173,185,
"240",2000,"35-39",478,236,242,
"240",2000,"40-44",553,284,269,
"240",2000,"45-49",541,284,257,
"240",2000,"50-54",444,240,204,
"240",2000,"55-59",340,190,150,
"240",2000,"60-64",262,146,116,
"240",2000,"65-69",150,82,68,
"240",2000,"70-74",118,59,59,
"240",2000,"75-79",53,31,22,
"240",2000,"80-84",35,13,22,
"240",2000,"85+",19,6,13,
"261",2000,"0-4",679,331,348,
"261",2000,"5-9",799,431,368,
"261",2000,"10-14",994,531,463,
"261",2000,"15-19",784,408,376,
"261",2000,"20-24",477,283,194,
"261",2000,"25-29",500,229,271,
"261",2000,"30-34",669,346,323,
"261",2000,"35-39",895,478,417,
"261",2000,"40-44",1084,550,534,
"261",2000,"45-49",1028,567,461,
"261",2000,"50-54",857,474,383,
"261",2000,"55-59",506,306,200,
"261",2000,"60-64",309,173,136,
"261",2000,"65-69",206,117,89,
"261",2000,"70-74",187,99,88,
"261",2000,"75-79",117,53,64,
"261",2000,"80-84",55,27,28,
"261",2000,"85+",49,25,24,
"270",2000,"0-4",744,401,343,
"270",2000,"5-9",953,509,444,
"270",2000,"10-14",1063,553,510,
"270",2000,"15-19",754,381,373,
"270",2000,"20-24",441,217,224,
"270",2000,"25-29",447,223,224,
"270",2000,"30-34",486,249,237,
"270",2000,"35-39",438,233,205,
"270",2000,"40-44",430,235,195,
"270",2000,"45-49",308,164,144,
"270",2000,"50-54",270,154,116,
"270",2000,"55-59",196,105,91,
"270",2000,"60-64",146,74,72,
"270",2000,"65-69",138,68,70,
"270",2000,"70-74",90,40,50,
"270",2000,"75-79",78,42,36,
"270",2000,"80-84",25,12,13,
"270",2000,"85+",21,6,15,
"275",2000,"0-4",148,80,68,
"275",2000,"5-9",181,94,87,
"275",2000,"10-14",241,131,110,
"275",2000,"15-19",170,89,81,
"275",2000,"20-24",84,47,37,
"275",2000,"25-29",101,46,55,
"275",2000,"30-34",135,61,74,
"275",2000,"35-39",176,84,92,
"275",2000,"40-44",248,125,123,
"275",2000,"45-49",237,129,108,
"275",2000,"50-54",182,94,88,
"275",2000,"55-59",142,76,66,
"275",2000,"60-64",122,72,50,
"275",2000,"65-69",81,44,37,
"275",2000,"70-74",75,38,37,
"275",2000,"75-79",49,22,27,
"275",2000,"80-84",41,20,21,
"275",2000,"85+",35,8,27,
"282",2000,"0-4",39,18,21,
"282",2000,"5-9",79,46,33,
"282",2000,"10-14",66,32,34,
"282",2000,"15-19",60,37,23,
"282",2000,"20-24",26,14,12,
"282",2000,"25-29",35,17,18,
"282",2000,"30-34",59,31,28,
"282",2000,"35-39",80,49,31,
"282",2000,"40-44",89,59,30,
"282",2000,"45-49",94,62,32,
"282",2000,"50-54",69,41,28,
"282",2000,"55-59",40,31,9,
"282",2000,"60-64",29,18,11,
"282",2000,"65-69",18,10,8,
"282",2000,"70-74",14,8,6,
"282",2000,"75-79",10,5,5,
"282",2000,"80-84",0,0,0,
"282",2000,"85+",1,1,0,
"290",2000,"0-4",464,238,226,
"290",2000,"5-9",592,307,285,
"290",2000,"10-14",788,428,360,
"290",2000,"15-19",636,343,293,
"290",2000,"20-24",369,233,136,
"290",2000,"25-29",328,180,148,
"290",2000,"30-34",370,197,173,
"290",2000,"35-39",505,258,247,
"290",2000,"40-44",546,294,252,
"290",2000,"45-49",531,291,240,
"290",2000,"50-54",414,231,183,
"290",2000,"55-59",301,178,123,
"290",2000,"60-64",193,105,88,
"290",2000,"65-69",165,84,81,
"290",2000,"70-74",145,78,67,
"290",2000,"75-79",74,39,35,
"290",2000,"80-84",48,25,23,
"290",2000,"85+",41,20,21,
"000",2001,"0-4",47270,24295,22975,
"000",2001,"5-9",51809,26494,25315,
"000",2001,"10-14",57106,29185,27921,
"000",2001,"15-19",52849,27718,25131,
"000",2001,"20-24",39721,21356,18365,
"000",2001,"25-29",41695,21677,20018,
"000",2001,"30-34",46498,23946,22552,
"000",2001,"35-39",53806,27674,26132,
"000",2001,"40-44",58350,29769,28581,
"000",2001,"45-49",55134,28603,26531,
"000",2001,"50-54",44554,24062,20492,
"000",2001,"55-59",28712,15318,13394,
"000",2001,"60-64",18413,9853,8560,
"000",2001,"65-69",12748,6482,6266,
"000",2001,"70-74",10145,4988,5157,
"000",2001,"75-79",7079,3196,3883,
"000",2001,"80-84",3938,1608,2330,
"000",2001,"85+",2889,983,1906,
"013",2001,"0-4",84,40,44,
"013",2001,"5-9",107,54,53,
"013",2001,"10-14",118,65,53,
"013",2001,"15-19",125,69,56,
"013",2001,"20-24",204,144,60,
"013",2001,"25-29",167,109,58,
"013",2001,"30-34",246,173,73,
"013",2001,"35-39",348,260,88,
"013",2001,"40-44",317,222,95,
"013",2001,"45-49",265,174,91,
"013",2001,"50-54",268,170,98,
"013",2001,"55-59",154,99,55,
"013",2001,"60-64",84,51,33,
"013",2001,"65-69",29,20,9,
"013",2001,"70-74",16,13,3,
"013",2001,"75-79",10,5,5,
"013",2001,"80-84",11,7,4,
"013",2001,"85+",0,0,0,
"016",2001,"0-4",217,111,106,
"016",2001,"5-9",250,134,116,
"016",2001,"10-14",233,120,113,
"016",2001,"15-19",259,131,128,
"016",2001,"20-24",288,198,90,
"016",2001,"25-29",431,288,143,
"016",2001,"30-34",660,458,202,
"016",2001,"35-39",748,527,221,
"016",2001,"40-44",677,464,213,
"016",2001,"45-49",561,372,189,
"016",2001,"50-54",475,336,139,
"016",2001,"55-59",225,137,88,
"016",2001,"60-64",152,94,58,
"016",2001,"65-69",55,29,26,
"016",2001,"70-74",29,13,16,
"016",2001,"75-79",14,9,5,
"016",2001,"80-84",10,2,8,
"016",2001,"85+",8,2,6,
"020",2001,"0-4",20043,10225,9818,
"020",2001,"5-9",21482,10962,10520,
"020",2001,"10-14",21969,11212,10757,
"020",2001,"15-19",20419,10510,9909,
"020",2001,"20-24",18036,9346,8690,
"020",2001,"25-29",19497,10080,9417,
"020",2001,"30-34",20972,10702,10270,
"020",2001,"35-39",23273,11629,11644,
"020",2001,"40-44",24406,12108,12298,
"020",2001,"45-49",22508,11339,11169,
"020",2001,"50-54",18284,9553,8731,
"020",2001,"55-59",11860,6124,5736,
"020",2001,"60-64",7177,3644,3533,
"020",2001,"65-69",5059,2465,2594,
"020",2001,"70-74",3999,1824,2175,
"020",2001,"75-79",2861,1216,1645,
"020",2001,"80-84",1607,613,994,
"020",2001,"85+",1148,365,783,
"050",2001,"0-4",1654,891,763,
"050",2001,"5-9",1798,963,835,
"050",2001,"10-14",1931,999,932,
"050",2001,"15-19",1591,852,739,
"050",2001,"20-24",1000,525,475,
"050",2001,"25-29",982,492,490,
"050",2001,"30-34",1105,584,521,
"050",2001,"35-39",1290,699,591,
"050",2001,"40-44",1152,612,540,
"050",2001,"45-49",995,554,441,
"050",2001,"50-54",777,448,329,
"050",2001,"55-59",577,311,266,
"050",2001,"60-64",374,193,181,
"050",2001,"65-69",302,136,166,
"050",2001,"70-74",216,124,92,
"050",2001,"75-79",152,79,73,
"050",2001,"80-84",95,41,54,
"050",2001,"85+",75,31,44,
"060",2001,"0-4",82,46,36,
"060",2001,"5-9",91,40,51,
"060",2001,"10-14",125,65,60,
"060",2001,"15-19",101,51,50,
"060",2001,"20-24",36,21,15,
"060",2001,"25-29",43,25,18,
"060",2001,"30-34",63,35,28,
"060",2001,"35-39",115,57,58,
"060",2001,"40-44",167,100,67,
"060",2001,"45-49",116,62,54,
"060",2001,"50-54",99,60,39,
"060",2001,"55-59",51,31,20,
"060",2001,"60-64",33,19,14,
"060",2001,"65-69",26,16,10,
"060",2001,"70-74",14,10,4,
"060",2001,"75-79",9,4,5,
"060",2001,"80-84",3,2,1,
"060",2001,"85+",3,1,2,
"068",2001,"0-4",97,54,43,
"068",2001,"5-9",108,54,54,
"068",2001,"10-14",154,87,67,
"068",2001,"15-19",131,68,63,
"068",2001,"20-24",77,52,25,
"068",2001,"25-29",123,68,55,
"068",2001,"30-34",144,85,59,
"068",2001,"35-39",170,98,72,
"068",2001,"40-44",234,130,104,
"068",2001,"45-49",247,147,100,
"068",2001,"50-54",170,105,65,
"068",2001,"55-59",100,64,36,
"068",2001,"60-64",79,51,28,
"068",2001,"65-69",26,17,9,
"068",2001,"70-74",13,8,5,
"068",2001,"75-79",6,4,2,
"068",2001,"80-84",5,4,1,
"068",2001,"85+",5,0,5,
"070",2001,"0-4",444,230,214,
"070",2001,"5-9",522,294,228,
"070",2001,"10-14",595,295,300,
"070",2001,"15-19",442,233,209,
"070",2001,"20-24",245,133,112,
"070",2001,"25-29",247,125,122,
"070",2001,"30-34",295,152,143,
"070",2001,"35-39",436,230,206,
"070",2001,"40-44",375,195,180,
"070",2001,"45-49",395,206,189,
"070",2001,"50-54",269,132,137,
"070",2001,"55-59",209,114,95,
"070",2001,"60-64",136,71,65,
"070",2001,"65-69",84,47,37,
"070",2001,"70-74",92,47,45,
"070",2001,"75-79",54,26,28,
"070",2001,"80-84",21,9,12,
"070",2001,"85+",24,11,13,
"090",2001,"0-4",6832,3463,3369,
"090",2001,"5-9",6675,3370,3305,
"090",2001,"10-14",7167,3638,3529,
"090",2001,"15-19",6676,3561,3115,
"090",2001,"20-24",7671,4309,3362,
"090",2001,"25-29",7284,3980,3304,
"090",2001,"30-34",6470,3338,3132,
"090",2001,"35-39",6848,3513,3335,
"090",2001,"40-44",6929,3449,3480,
"090",2001,"45-49",6545,3327,3218,
"090",2001,"50-54",5399,2993,2406,
"090",2001,"55-59",3301,1783,1518,
"090",2001,"60-64",2117,1117,1000,
"090",2001,"65-69",1341,713,628,
"090",2001,"70-74",1102,566,536,
"090",2001,"75-79",746,327,419,
"090",2001,"80-84",453,188,265,
"090",2001,"85+",316,123,193,
"100",2001,"0-4",119,59,60,
"100",2001,"5-9",147,74,73,
"100",2001,"10-14",199,98,101,
"100",2001,"15-19",195,104,91,
"100",2001,"20-24",81,43,38,
"100",2001,"25-29",76,29,47,
"100",2001,"30-34",141,70,71,
"100",2001,"35-39",173,77,96,
"100",2001,"40-44",232,125,107,
"100",2001,"45-49",265,144,121,
"100",2001,"50-54",262,139,123,
"100",2001,"55-59",160,73,87,
"100",2001,"60-64",92,48,44,
"100",2001,"65-69",85,44,41,
"100",2001,"70-74",65,38,27,
"100",2001,"75-79",54,28,26,
"100",2001,"80-84",30,15,15,
"100",2001,"85+",29,12,17,
"105",2001,"0-4",123,65,58,
"105",2001,"5-9",180,101,79,
"105",2001,"10-14",223,111,112,
"105",2001,"15-19",216,112,104,
"105",2001,"20-24",125,65,60,
"105",2001,"25-29",92,51,41,
"105",2001,"30-34",120,76,44,
"105",2001,"35-39",197,103,94,
"105",2001,"40-44",225,124,101,
"105",2001,"45-49",233,122,111,
"105",2001,"50-54",222,124,98,
"105",2001,"55-59",158,92,66,
"105",2001,"60-64",119,70,49,
"105",2001,"65-69",74,50,24,
"105",2001,"70-74",46,26,20,
"105",2001,"75-79",34,18,16,
"105",2001,"80-84",18,7,11,
"105",2001,"85+",21,6,15,
"110",2001,"0-4",1973,1016,957,
"110",2001,"5-9",2222,1123,1099,
"110",2001,"10-14",2482,1244,1238,
"110",2001,"15-19",2516,1336,1180,
"110",2001,"20-24",1520,761,759,
"110",2001,"25-29",1835,878,957,
"110",2001,"30-34",2257,1185,1072,
"110",2001,"35-39",2672,1334,1338,
"110",2001,"40-44",2951,1462,1489,
"110",2001,"45-49",3045,1512,1533,
"110",2001,"50-54",2658,1394,1264,
"110",2001,"55-59",1558,799,759,
"110",2001,"60-64",922,506,416,
"110",2001,"65-69",565,271,294,
"110",2001,"70-74",507,245,262,
"110",2001,"75-79",354,142,212,
"110",2001,"80-84",275,102,173,
"110",2001,"85+",170,62,108,
"122",2001,"0-4",3248,1633,1615,
"122",2001,"5-9",3844,1992,1852,
"122",2001,"10-14",4624,2313,2311,
"122",2001,"15-19",4603,2440,2163,
"122",2001,"20-24",2000,1155,845,
"122",2001,"25-29",2373,1257,1116,
"122",2001,"30-34",3042,1527,1515,
"122",2001,"35-39",3859,1997,1862,
"122",2001,"40-44",4984,2561,2423,
"122",2001,"45-49",5159,2676,2483,
"122",2001,"50-54",4023,2199,1824,
"122",2001,"55-59",2766,1491,1275,
"122",2001,"60-64",1834,1003,831,
"122",2001,"65-69",1372,714,658,
"122",2001,"70-74",1059,533,526,
"122",2001,"75-79",788,386,402,
"122",2001,"80-84",381,153,228,
"122",2001,"85+",231,85,146,
"130",2001,"0-4",919,465,454,
"130",2001,"5-9",1072,563,509,
"130",2001,"10-14",1176,591,585,
"130",2001,"15-19",1062,537,525,
"130",2001,"20-24",650,345,305,
"130",2001,"25-29",689,334,355,
"130",2001,"30-34",983,479,504,
"130",2001,"35-39",1166,627,539,
"130",2001,"40-44",1355,688,667,
"130",2001,"45-49",1239,629,610,
"130",2001,"50-54",1116,602,514,
"130",2001,"55-59",761,399,362,
"130",2001,"60-64",506,295,211,
"130",2001,"65-69",323,156,167,
"130",2001,"70-74",308,151,157,
"130",2001,"75-79",227,104,123,
"130",2001,"80-84",134,56,78,
"130",2001,"85+",109,36,73,
"150",2001,"0-4",1215,627,588,
"150",2001,"5-9",1148,563,585,
"150",2001,"10-14",1344,696,648,
"150",2001,"15-19",1053,548,505,
"150",2001,"20-24",746,413,333,
"150",2001,"25-29",820,450,370,
"150",2001,"30-34",1076,569,507,
"150",2001,"35-39",1279,667,612,
"150",2001,"40-44",1258,695,563,
"150",2001,"45-49",1150,642,508,
"150",2001,"50-54",890,471,419,
"150",2001,"55-59",527,282,245,
"150",2001,"60-64",332,190,142,
"150",2001,"65-69",271,145,126,
"150",2001,"70-74",187,98,89,
"150",2001,"75-79",102,52,50,
"150",2001,"80-84",74,39,35,
"150",2001,"85+",45,19,26,
"164",2001,"0-4",116,49,67,
"164",2001,"5-9",191,98,93,
"164",2001,"10-14",216,109,107,
"164",2001,"15-19",183,95,88,
"164",2001,"20-24",97,56,41,
"164",2001,"25-29",67,29,38,
"164",2001,"30-34",73,40,33,
"164",2001,"35-39",144,82,62,
"164",2001,"40-44",182,100,82,
"164",2001,"45-49",143,76,67,
"164",2001,"50-54",92,57,35,
"164",2001,"55-59",78,40,38,
"164",2001,"60-64",54,33,21,
"164",2001,"65-69",39,23,16,
"164",2001,"70-74",27,17,10,
"164",2001,"75-79",20,14,6,
"164",2001,"80-84",9,4,5,
"164",2001,"85+",8,2,6,
"170",2001,"0-4",4058,2099,1959,
"170",2001,"5-9",5190,2615,2575,
"170",2001,"10-14",6231,3260,2971,
"170",2001,"15-19",6107,3279,2828,
"170",2001,"20-24",2844,1509,1335,
"170",2001,"25-29",2869,1404,1465,
"170",2001,"30-34",4015,1984,2031,
"170",2001,"35-39",5211,2612,2599,
"170",2001,"40-44",6432,3324,3108,
"170",2001,"45-49",6037,3187,2850,
"170",2001,"50-54",4393,2370,2023,
"170",2001,"55-59",2809,1558,1251,
"170",2001,"60-64",1938,1068,870,
"170",2001,"65-69",1387,719,668,
"170",2001,"70-74",1106,585,521,
"170",2001,"75-79",694,332,362,
"170",2001,"80-84",347,153,194,
"170",2001,"85+",239,79,160,
"180",2001,"0-4",846,459,387,
"180",2001,"5-9",925,489,436,
"180",2001,"10-14",1078,547,531,
"180",2001,"15-19",897,477,420,
"180",2001,"20-24",575,320,255,
"180",2001,"25-29",615,307,308,
"180",2001,"30-34",580,320,260,
"180",2001,"35-39",724,426,298,
"180",2001,"40-44",730,398,332,
"180",2001,"45-49",624,352,272,
"180",2001,"50-54",543,338,205,
"180",2001,"55-59",347,179,168,
"180",2001,"60-64",232,128,104,
"180",2001,"65-69",182,109,73,
"180",2001,"70-74",142,66,76,
"180",2001,"75-79",104,52,52,
"180",2001,"80-84",56,28,28,
"180",2001,"85+",60,14,46,
"185",2001,"0-4",679,387,292,
"185",2001,"5-9",699,342,357,
"185",2001,"10-14",857,441,416,
"185",2001,"15-19",773,411,362,
"185",2001,"20-24",435,223,212,
"185",2001,"25-29",416,223,193,
"185",2001,"30-34",489,260,229,
"185",2001,"35-39",595,320,275,
"185",2001,"40-44",592,315,277,
"185",2001,"45-49",531,297,234,
"185",2001,"50-54",408,235,173,
"185",2001,"55-59",269,150,119,
"185",2001,"60-64",179,100,79,
"185",2001,"65-69",116,61,55,
"185",2001,"70-74",78,36,42,
"185",2001,"75-79",48,16,32,
"185",2001,"80-84",34,12,22,
"185",2001,"85+",23,3,20,
"188",2001,"0-4",747,384,363,
"188",2001,"5-9",783,408,375,
"188",2001,"10-14",925,474,451,
"188",2001,"15-19",744,386,358,
"188",2001,"20-24",472,246,226,
"188",2001,"25-29",453,235,218,
"188",2001,"30-34",477,274,203,
"188",2001,"35-39",547,298,249,
"188",2001,"40-44",479,275,204,
"188",2001,"45-49",436,263,173,
"188",2001,"50-54",350,202,148,
"188",2001,"55-59",222,119,103,
"188",2001,"60-64",147,89,58,
"188",2001,"65-69",119,57,62,
"188",2001,"70-74",120,52,68,
"188",2001,"75-79",62,28,34,
"188",2001,"80-84",28,15,13,
"188",2001,"85+",24,9,15,
"195",2001,"0-4",294,158,136,
"195",2001,"5-9",325,162,163,
"195",2001,"10-14",407,208,199,
"195",2001,"15-19",325,175,150,
"195",2001,"20-24",187,101,86,
"195",2001,"25-29",207,109,98,
"195",2001,"30-34",304,163,141,
"195",2001,"35-39",318,164,154,
"195",2001,"40-44",400,195,205,
"195",2001,"45-49",402,218,184,
"195",2001,"50-54",336,183,153,
"195",2001,"55-59",234,131,103,
"195",2001,"60-64",145,81,64,
"195",2001,"65-69",91,50,41,
"195",2001,"70-74",91,45,46,
"195",2001,"75-79",89,42,47,
"195",2001,"80-84",50,23,27,
"195",2001,"85+",55,23,32,
"198",2001,"0-4",423,223,200,
"198",2001,"5-9",471,250,221,
"198",2001,"10-14",530,271,259,
"198",2001,"15-19",496,267,229,
"198",2001,"20-24",294,169,125,
"198",2001,"25-29",275,143,132,
"198",2001,"30-34",346,176,170,
"198",2001,"35-39",470,243,227,
"198",2001,"40-44",555,306,249,
"198",2001,"45-49",564,326,238,
"198",2001,"50-54",443,259,184,
"198",2001,"55-59",345,202,143,
"198",2001,"60-64",229,140,89,
"198",2001,"65-69",148,95,53,
"198",2001,"70-74",99,59,40,
"198",2001,"75-79",69,36,33,
"198",2001,"80-84",26,10,16,
"198",2001,"85+",21,10,11,
"220",2001,"0-4",562,317,245,
"220",2001,"5-9",623,306,317,
"220",2001,"10-14",732,360,372,
"220",2001,"15-19",689,349,340,
"220",2001,"20-24",524,307,217,
"220",2001,"25-29",523,251,272,
"220",2001,"30-34",609,305,304,
"220",2001,"35-39",717,381,336,
"220",2001,"40-44",798,391,407,
"220",2001,"45-49",778,396,382,
"220",2001,"50-54",647,348,299,
"220",2001,"55-59",418,226,192,
"220",2001,"60-64",369,197,172,
"220",2001,"65-69",258,119,139,
"220",2001,"70-74",190,104,86,
"220",2001,"75-79",150,62,88,
"220",2001,"80-84",69,31,38,
"220",2001,"85+",81,18,63,
"230",2001,"0-4",37,17,20,
"230",2001,"5-9",58,26,32,
"230",2001,"10-14",46,24,22,
"230",2001,"15-19",32,17,15,
"230",2001,"20-24",34,19,15,
"230",2001,"25-29",67,32,35,
"230",2001,"30-34",78,41,37,
"230",2001,"35-39",71,40,31,
"230",2001,"40-44",75,42,33,
"230",2001,"45-49",91,56,35,
"230",2001,"50-54",83,44,39,
"230",2001,"55-59",63,27,36,
"230",2001,"60-64",37,21,16,
"230",2001,"65-69",23,13,10,
"230",2001,"70-74",21,10,11,
"230",2001,"75-79",15,6,9,
"230",2001,"80-84",8,5,3,
"230",2001,"85+",9,3,6,
"240",2001,"0-4",370,187,183,
"240",2001,"5-9",497,260,237,
"240",2001,"10-14",621,287,334,
"240",2001,"15-19",588,324,264,
"240",2001,"20-24",253,140,113,
"240",2001,"25-29",244,120,124,
"240",2001,"30-34",329,150,179,
"240",2001,"35-39",408,206,202,
"240",2001,"40-44",530,277,253,
"240",2001,"45-49",564,295,269,
"240",2001,"50-54",461,250,211,
"240",2001,"55-59",304,175,129,
"240",2001,"60-64",283,164,119,
"240",2001,"65-69",158,87,71,
"240",2001,"70-74",120,58,62,
"240",2001,"75-79",63,36,27,
"240",2001,"80-84",28,11,17,
"240",2001,"85+",26,6,20,
"261",2001,"0-4",684,342,342,
"261",2001,"5-9",743,391,352,
"261",2001,"10-14",949,501,448,
"261",2001,"15-19",882,470,412,
"261",2001,"20-24",428,256,172,
"261",2001,"25-29",447,215,232,
"261",2001,"30-34",642,315,327,
"261",2001,"35-39",847,450,397,
"261",2001,"40-44",1041,537,504,
"261",2001,"45-49",1051,564,487,
"261",2001,"50-54",887,500,387,
"261",2001,"55-59",545,330,215,
"261",2001,"60-64",320,185,135,
"261",2001,"65-69",211,114,97,
"261",2001,"70-74",170,95,75,
"261",2001,"75-79",132,60,72,
"261",2001,"80-84",52,24,28,
"261",2001,"85+",52,23,29,
"270",2001,"0-4",778,420,358,
"270",2001,"5-9",878,463,415,
"270",2001,"10-14",1102,587,515,
"270",2001,"15-19",837,417,420,
"270",2001,"20-24",438,223,215,
"270",2001,"25-29",439,215,224,
"270",2001,"30-34",465,232,233,
"270",2001,"35-39",448,249,199,
"270",2001,"40-44",437,235,202,
"270",2001,"45-49",330,177,153,
"270",2001,"50-54",278,151,127,
"270",2001,"55-59",207,113,94,
"270",2001,"60-64",143,76,67,
"270",2001,"65-69",148,71,77,
"270",2001,"70-74",98,44,54,
"270",2001,"75-79",78,41,37,
"270",2001,"80-84",26,10,16,
"270",2001,"85+",19,7,12,
"275",2001,"0-4",144,78,66,
"275",2001,"5-9",170,88,82,
"275",2001,"10-14",224,121,103,
"275",2001,"15-19",176,94,82,
"275",2001,"20-24",80,45,35,
"275",2001,"25-29",84,39,45,
"275",2001,"30-34",120,53,67,
"275",2001,"35-39",162,77,85,
"275",2001,"40-44",227,113,114,
"275",2001,"45-49",236,128,108,
"275",2001,"50-54",190,100,90,
"275",2001,"55-59",147,78,69,
"275",2001,"60-64",127,74,53,
"275",2001,"65-69",87,48,39,
"275",2001,"70-74",74,38,36,
"275",2001,"75-79",52,24,28,
"275",2001,"80-84",39,19,20,
"275",2001,"85+",45,12,33,
"282",2001,"0-4",30,15,15,
"282",2001,"5-9",61,34,27,
"282",2001,"10-14",65,32,33,
"282",2001,"15-19",57,36,21,
"282",2001,"20-24",17,9,8,
"282",2001,"25-29",20,11,9,
"282",2001,"30-34",47,23,24,
"282",2001,"35-39",70,43,27,
"282",2001,"40-44",85,60,25,
"282",2001,"45-49",88,58,30,
"282",2001,"50-54",63,39,24,
"282",2001,"55-59",38,27,11,
"282",2001,"60-64",30,21,9,
"282",2001,"65-69",15,7,8,
"282",2001,"70-74",14,9,5,
"282",2001,"75-79",9,3,6,
"282",2001,"80-84",1,1,0,
"282",2001,"85+",2,2,0,
"290",2001,"0-4",452,235,217,
"290",2001,"5-9",549,275,274,
"290",2001,"10-14",783,429,354,
"290",2001,"15-19",674,369,305,
"290",2001,"20-24",364,223,141,
"290",2001,"25-29",310,178,132,
"290",2001,"30-34",350,177,173,
"290",2001,"35-39",500,265,235,
"290",2001,"40-44",525,266,259,
"290",2001,"45-49",536,304,232,
"290",2001,"50-54",468,260,208,
"290",2001,"55-59",279,164,115,
"290",2001,"60-64",223,124,99,
"290",2001,"65-69",154,86,68,
"290",2001,"70-74",142,74,68,
"290",2001,"75-79",83,44,39,
"290",2001,"80-84",48,24,24,
"290",2001,"85+",41,19,22,
"000",2002,"0-4",47584,24415,23169,
"000",2002,"5-9",50275,25731,24544,
"000",2002,"10-14",57567,29413,28154,
"000",2002,"15-19",54772,28502,26270,
"000",2002,"20-24",40892,22271,18621,
"000",2002,"25-29",41539,21651,19888,
"000",2002,"30-34",46790,24026,22764,
"000",2002,"35-39",51944,26811,25133,
"000",2002,"40-44",58060,29620,28440,
"000",2002,"45-49",56549,29208,27341,
"000",2002,"50-54",46319,24846,21473,
"000",2002,"55-59",31668,16955,14713,
"000",2002,"60-64",19740,10557,9183,
"000",2002,"65-69",13222,6738,6484,
"000",2002,"70-74",10210,5035,5175,
"000",2002,"75-79",7261,3298,3963,
"000",2002,"80-84",4237,1754,2483,
"000",2002,"85+",3100,1042,2058,
"013",2002,"0-4",90,41,49,
"013",2002,"5-9",122,61,61,
"013",2002,"10-14",122,63,59,
"013",2002,"15-19",133,70,63,
"013",2002,"20-24",214,151,63,
"013",2002,"25-29",209,133,76,
"013",2002,"30-34",231,166,65,
"013",2002,"35-39",343,248,95,
"013",2002,"40-44",347,237,110,
"013",2002,"45-49",311,214,97,
"013",2002,"50-54",269,166,103,
"013",2002,"55-59",184,119,65,
"013",2002,"60-64",85,49,36,
"013",2002,"65-69",32,21,11,
"013",2002,"70-74",12,9,3,
"013",2002,"75-79",14,9,5,
"013",2002,"80-84",9,6,3,
"013",2002,"85+",5,2,3,
"016",2002,"0-4",195,97,98,
"016",2002,"5-9",242,123,119,
"016",2002,"10-14",227,126,101,
"016",2002,"15-19",243,118,125,
"016",2002,"20-24",249,174,75,
"016",2002,"25-29",414,279,135,
"016",2002,"30-34",589,409,180,
"016",2002,"35-39",726,521,205,
"016",2002,"40-44",693,466,227,
"016",2002,"45-49",576,414,162,
"016",2002,"50-54",480,330,150,
"016",2002,"55-59",247,150,97,
"016",2002,"60-64",129,83,46,
"016",2002,"65-69",73,36,37,
"016",2002,"70-74",26,13,13,
"016",2002,"75-79",16,7,9,
"016",2002,"80-84",10,3,7,
"016",2002,"85+",6,1,5,
"020",2002,"0-4",20164,10289,9875,
"020",2002,"5-9",20708,10561,10147,
"020",2002,"10-14",22333,11388,10945,
"020",2002,"15-19",20876,10718,10158,
"020",2002,"20-24",18455,9698,8757,
"020",2002,"25-29",19487,10095,9392,
"020",2002,"30-34",21190,10760,10430,
"020",2002,"35-39",22327,11224,11103,
"020",2002,"40-44",24253,12055,12198,
"020",2002,"45-49",23114,11563,11551,
"020",2002,"50-54",18679,9668,9011,
"020",2002,"55-59",13060,6823,6237,
"020",2002,"60-64",7715,3915,3800,
"020",2002,"65-69",5101,2494,2607,
"020",2002,"70-74",4018,1831,2187,
"020",2002,"75-79",2910,1245,1665,
"020",2002,"80-84",1733,671,1062,
"020",2002,"85+",1216,376,840,
"050",2002,"0-4",1738,924,814,
"050",2002,"5-9",1719,949,770,
"050",2002,"10-14",1999,993,1006,
"050",2002,"15-19",1672,911,761,
"050",2002,"20-24",1037,539,498,
"050",2002,"25-29",994,503,491,
"050",2002,"30-34",1084,559,525,
"050",2002,"35-39",1290,713,577,
"050",2002,"40-44",1199,646,553,
"050",2002,"45-49",1000,553,447,
"050",2002,"50-54",851,484,367,
"050",2002,"55-59",573,304,269,
"050",2002,"60-64",421,221,200,
"050",2002,"65-69",309,147,162,
"050",2002,"70-74",226,123,103,
"050",2002,"75-79",142,78,64,
"050",2002,"80-84",99,43,56,
"050",2002,"85+",85,34,51,
"060",2002,"0-4",77,41,36,
"060",2002,"5-9",94,43,51,
"060",2002,"10-14",121,62,59,
"060",2002,"15-19",106,60,46,
"060",2002,"20-24",32,15,17,
"060",2002,"25-29",41,28,13,
"060",2002,"30-34",65,34,31,
"060",2002,"35-39",101,51,50,
"060",2002,"40-44",167,96,71,
"060",2002,"45-49",123,64,59,
"060",2002,"50-54",94,56,38,
"060",2002,"55-59",64,39,25,
"060",2002,"60-64",32,21,11,
"060",2002,"65-69",23,11,12,
"060",2002,"70-74",16,12,4,
"060",2002,"75-79",10,5,5,
"060",2002,"80-84",2,1,1,
"060",2002,"85+",2,2,0,
"068",2002,"0-4",99,59,40,
"068",2002,"5-9",100,49,51,
"068",2002,"10-14",146,84,62,
"068",2002,"15-19",144,74,70,
"068",2002,"20-24",60,40,20,
"068",2002,"25-29",108,63,45,
"068",2002,"30-34",155,86,69,
"068",2002,"35-39",159,91,68,
"068",2002,"40-44",215,126,89,
"068",2002,"45-49",244,143,101,
"068",2002,"50-54",188,113,75,
"068",2002,"55-59",108,68,40,
"068",2002,"60-64",75,52,23,
"068",2002,"65-69",36,23,13,
"068",2002,"70-74",9,4,5,
"068",2002,"75-79",8,6,2,
"068",2002,"80-84",6,4,2,
"068",2002,"85+",3,0,3,
"070",2002,"0-4",426,227,199,
"070",2002,"5-9",512,275,237,
"070",2002,"10-14",595,305,290,
"070",2002,"15-19",492,251,241,
"070",2002,"20-24",237,132,105,
"070",2002,"25-29",233,115,118,
"070",2002,"30-34",291,151,140,
"070",2002,"35-39",408,211,197,
"070",2002,"40-44",386,206,180,
"070",2002,"45-49",404,210,194,
"070",2002,"50-54",300,150,150,
"070",2002,"55-59",215,115,100,
"070",2002,"60-64",129,70,59,
"070",2002,"65-69",100,54,46,
"070",2002,"70-74",83,43,40,
"070",2002,"75-79",58,29,29,
"070",2002,"80-84",23,10,13,
"070",2002,"85+",19,9,10,
"090",2002,"0-4",6998,3534,3464,
"090",2002,"5-9",6568,3337,3231,
"090",2002,"10-14",7177,3633,3544,
"090",2002,"15-19",6886,3637,3249,
"090",2002,"20-24",7773,4418,3355,
"090",2002,"25-29",7678,4166,3512,
"090",2002,"30-34",6590,3421,3169,
"090",2002,"35-39",6664,3434,3230,
"090",2002,"40-44",6979,3474,3505,
"090",2002,"45-49",6704,3359,3345,
"090",2002,"50-54",5636,3092,2544,
"090",2002,"55-59",3765,2046,1719,
"090",2002,"60-64",2279,1213,1066,
"090",2002,"65-69",1415,742,673,
"090",2002,"70-74",1162,604,558,
"090",2002,"75-79",732,316,416,
"090",2002,"80-84",502,215,287,
"090",2002,"85+",352,126,226,
"100",2002,"0-4",119,57,62,
"100",2002,"5-9",144,71,73,
"100",2002,"10-14",185,100,85,
"100",2002,"15-19",212,105,107,
"100",2002,"20-24",76,40,36,
"100",2002,"25-29",67,27,40,
"100",2002,"30-34",138,67,71,
"100",2002,"35-39",170,85,85,
"100",2002,"40-44",212,108,104,
"100",2002,"45-49",273,149,124,
"100",2002,"50-54",268,144,124,
"100",2002,"55-59",182,81,101,
"100",2002,"60-64",104,54,50,
"100",2002,"65-69",81,42,39,
"100",2002,"70-74",65,36,29,
"100",2002,"75-79",63,36,27,
"100",2002,"80-84",27,14,13,
"100",2002,"85+",26,8,18,
"105",2002,"0-4",112,60,52,
"105",2002,"5-9",162,88,74,
"105",2002,"10-14",207,105,102,
"105",2002,"15-19",208,105,103,
"105",2002,"20-24",123,68,55,
"105",2002,"25-29",80,45,35,
"105",2002,"30-34",108,68,40,
"105",2002,"35-39",174,94,80,
"105",2002,"40-44",217,117,100,
"105",2002,"45-49",225,121,104,
"105",2002,"50-54",221,121,100,
"105",2002,"55-59",171,100,71,
"105",2002,"60-64",121,72,49,
"105",2002,"65-69",82,53,29,
"105",2002,"70-74",46,29,17,
"105",2002,"75-79",34,18,16,
"105",2002,"80-84",18,8,10,
"105",2002,"85+",20,5,15,
"110",2002,"0-4",2026,1047,979,
"110",2002,"5-9",2187,1114,1073,
"110",2002,"10-14",2488,1238,1250,
"110",2002,"15-19",2568,1351,1217,
"110",2002,"20-24",1627,825,802,
"110",2002,"25-29",1845,876,969,
"110",2002,"30-34",2290,1198,1092,
"110",2002,"35-39",2582,1301,1281,
"110",2002,"40-44",2942,1439,1503,
"110",2002,"45-49",3094,1550,1544,
"110",2002,"50-54",2775,1452,1323,
"110",2002,"55-59",1708,885,823,
"110",2002,"60-64",979,531,448,
"110",2002,"65-69",601,291,310,
"110",2002,"70-74",495,240,255,
"110",2002,"75-79",365,147,218,
"110",2002,"80-84",276,99,177,
"110",2002,"85+",199,77,122,
"122",2002,"0-4",3222,1600,1622,
"122",2002,"5-9",3666,1883,1783,
"122",2002,"10-14",4637,2332,2305,
"122",2002,"15-19",4770,2520,2250,
"122",2002,"20-24",2217,1314,903,
"122",2002,"25-29",2164,1137,1027,
"122",2002,"30-34",3100,1565,1535,
"122",2002,"35-39",3652,1890,1762,
"122",2002,"40-44",4877,2508,2369,
"122",2002,"45-49",5226,2675,2551,
"122",2002,"50-54",4261,2309,1952,
"122",2002,"55-59",3041,1666,1375,
"122",2002,"60-64",2011,1077,934,
"122",2002,"65-69",1436,748,688,
"122",2002,"70-74",1092,563,529,
"122",2002,"75-79",822,405,417,
"122",2002,"80-84",431,185,246,
"122",2002,"85+",254,91,163,
"130",2002,"0-4",897,451,446,
"130",2002,"5-9",1015,533,482,
"130",2002,"10-14",1176,596,580,
"130",2002,"15-19",1085,542,543,
"130",2002,"20-24",683,374,309,
"130",2002,"25-29",657,329,328,
"130",2002,"30-34",971,478,493,
"130",2002,"35-39",1117,588,529,
"130",2002,"40-44",1324,683,641,
"130",2002,"45-49",1252,635,617,
"130",2002,"50-54",1130,611,519,
"130",2002,"55-59",823,420,403,
"130",2002,"60-64",532,300,232,
"130",2002,"65-69",321,166,155,
"130",2002,"70-74",298,141,157,
"130",2002,"75-79",222,104,118,
"130",2002,"80-84",135,52,83,
"130",2002,"85+",126,46,80,
"150",2002,"0-4",1160,595,565,
"150",2002,"5-9",1173,586,587,
"150",2002,"10-14",1335,677,658,
"150",2002,"15-19",1098,575,523,
"150",2002,"20-24",713,404,309,
"150",2002,"25-29",814,446,368,
"150",2002,"30-34",1066,570,496,
"150",2002,"35-39",1230,636,594,
"150",2002,"40-44",1270,711,559,
"150",2002,"45-49",1157,628,529,
"150",2002,"50-54",904,489,415,
"150",2002,"55-59",604,325,279,
"150",2002,"60-64",352,197,155,
"150",2002,"65-69",261,136,125,
"150",2002,"70-74",191,102,89,
"150",2002,"75-79",108,54,54,
"150",2002,"80-84",68,35,33,
"150",2002,"85+",53,23,30,
"164",2002,"0-4",113,53,60,
"164",2002,"5-9",169,87,82,
"164",2002,"10-14",199,96,103,
"164",2002,"15-19",194,102,92,
"164",2002,"20-24",94,57,37,
"164",2002,"25-29",54,21,33,
"164",2002,"30-34",59,34,25,
"164",2002,"35-39",128,72,56,
"164",2002,"40-44",178,101,77,
"164",2002,"45-49",131,70,61,
"164",2002,"50-54",108,62,46,
"164",2002,"55-59",64,33,31,
"164",2002,"60-64",58,32,26,
"164",2002,"65-69",38,26,12,
"164",2002,"70-74",30,18,12,
"164",2002,"75-79",17,12,5,
"164",2002,"80-84",10,5,5,
"164",2002,"85+",6,1,5,
"170",2002,"0-4",4075,2097,1978,
"170",2002,"5-9",5243,2676,2567,
"170",2002,"10-14",6442,3366,3076,
"170",2002,"15-19",6524,3444,3080,
"170",2002,"20-24",3130,1673,1457,
"170",2002,"25-29",2803,1375,1428,
"170",2002,"30-34",4140,2045,2095,
"170",2002,"35-39",5171,2605,2566,
"170",2002,"40-44",6503,3309,3194,
"170",2002,"45-49",6381,3382,2999,
"170",2002,"50-54",4845,2610,2235,
"170",2002,"55-59",3142,1709,1433,
"170",2002,"60-64",2155,1212,943,
"170",2002,"65-69",1504,764,740,
"170",2002,"70-74",1150,609,541,
"170",2002,"75-79",754,356,398,
"170",2002,"80-84",397,180,217,
"170",2002,"85+",277,90,187,
"180",2002,"0-4",885,480,405,
"180",2002,"5-9",845,453,392,
"180",2002,"10-14",1123,567,556,
"180",2002,"15-19",943,486,457,
"180",2002,"20-24",571,324,247,
"180",2002,"25-29",593,316,277,
"180",2002,"30-34",600,318,282,
"180",2002,"35-39",715,419,296,
"180",2002,"40-44",722,395,327,
"180",2002,"45-49",631,353,278,
"180",2002,"50-54",552,335,217,
"180",2002,"55-59",371,201,170,
"180",2002,"60-64",252,138,114,
"180",2002,"65-69",182,109,73,
"180",2002,"70-74",130,63,67,
"180",2002,"75-79",109,50,59,
"180",2002,"80-84",52,27,25,
"180",2002,"85+",59,16,43,
"185",2002,"0-4",714,397,317,
"185",2002,"5-9",648,326,322,
"185",2002,"10-14",847,440,407,
"185",2002,"15-19",789,412,377,
"185",2002,"20-24",469,237,232,
"185",2002,"25-29",385,203,182,
"185",2002,"30-34",464,255,209,
"185",2002,"35-39",596,323,273,
"185",2002,"40-44",571,310,261,
"185",2002,"45-49",557,295,262,
"185",2002,"50-54",407,244,163,
"185",2002,"55-59",285,159,126,
"185",2002,"60-64",185,100,85,
"185",2002,"65-69",124,66,58,
"185",2002,"70-74",72,34,38,
"185",2002,"75-79",52,19,33,
"185",2002,"80-84",36,13,23,
"185",2002,"85+",19,2,17,
"188",2002,"0-4",754,392,362,
"188",2002,"5-9",742,364,378,
"188",2002,"10-14",920,494,426,
"188",2002,"15-19",810,405,405,
"188",2002,"20-24",495,260,235,
"188",2002,"25-29",459,244,215,
"188",2002,"30-34",453,260,193,
"188",2002,"35-39",538,290,248,
"188",2002,"40-44",483,273,210,
"188",2002,"45-49",464,288,176,
"188",2002,"50-54",357,201,156,
"188",2002,"55-59",252,139,113,
"188",2002,"60-64",155,88,67,
"188",2002,"65-69",126,63,63,
"188",2002,"70-74",109,52,57,
"188",2002,"75-79",73,33,40,
"188",2002,"80-84",29,13,16,
"188",2002,"85+",26,10,16,
"195",2002,"0-4",279,147,132,
"195",2002,"5-9",317,160,157,
"195",2002,"10-14",385,196,189,
"195",2002,"15-19",338,180,158,
"195",2002,"20-24",187,104,83,
"195",2002,"25-29",187,97,90,
"195",2002,"30-34",284,152,132,
"195",2002,"35-39",315,163,152,
"195",2002,"40-44",371,182,189,
"195",2002,"45-49",407,216,191,
"195",2002,"50-54",339,186,153,
"195",2002,"55-59",251,139,112,
"195",2002,"60-64",158,89,69,
"195",2002,"65-69",98,55,43,
"195",2002,"70-74",84,42,42,
"195",2002,"75-79",87,41,46,
"195",2002,"80-84",54,25,29,
"195",2002,"85+",50,22,28,
"198",2002,"0-4",403,212,191,
"198",2002,"5-9",458,242,216,
"198",2002,"10-14",508,264,244,
"198",2002,"15-19",485,258,227,
"198",2002,"20-24",302,173,129,
"198",2002,"25-29",238,127,111,
"198",2002,"30-34",327,165,162,
"198",2002,"35-39",434,224,210,
"198",2002,"40-44",532,290,242,
"198",2002,"45-49",556,321,235,
"198",2002,"50-54",459,267,192,
"198",2002,"55-59",357,209,148,
"198",2002,"60-64",246,150,96,
"198",2002,"65-69",155,98,57,
"198",2002,"70-74",100,62,38,
"198",2002,"75-79",70,37,33,
"198",2002,"80-84",30,12,18,
"198",2002,"85+",19,8,11,
"220",2002,"0-4",593,331,262,
"220",2002,"5-9",603,309,294,
"220",2002,"10-14",703,346,357,
"220",2002,"15-19",703,346,357,
"220",2002,"20-24",544,322,222,
"220",2002,"25-29",517,255,262,
"220",2002,"30-34",611,297,314,
"220",2002,"35-39",676,359,317,
"220",2002,"40-44",775,397,378,
"220",2002,"45-49",789,397,392,
"220",2002,"50-54",680,361,319,
"220",2002,"55-59",470,242,228,
"220",2002,"60-64",374,208,166,
"220",2002,"65-69",268,125,143,
"220",2002,"70-74",187,97,90,
"220",2002,"75-79",153,64,89,
"220",2002,"80-84",71,33,38,
"220",2002,"85+",95,25,70,
"230",2002,"0-4",34,14,20,
"230",2002,"5-9",53,23,30,
"230",2002,"10-14",50,26,24,
"230",2002,"15-19",32,18,14,
"230",2002,"20-24",33,18,15,
"230",2002,"25-29",66,32,34,
"230",2002,"30-34",85,42,43,
"230",2002,"35-39",71,42,29,
"230",2002,"40-44",77,43,34,
"230",2002,"45-49",87,52,35,
"230",2002,"50-54",89,50,39,
"230",2002,"55-59",68,30,38,
"230",2002,"60-64",43,23,20,
"230",2002,"65-69",23,14,9,
"230",2002,"70-74",20,10,10,
"230",2002,"75-79",14,5,9,
"230",2002,"80-84",8,4,4,
"230",2002,"85+",8,3,5,
"240",2002,"0-4",343,171,172,
"240",2002,"5-9",486,244,242,
"240",2002,"10-14",585,279,306,
"240",2002,"15-19",626,340,286,
"240",2002,"20-24",240,133,107,
"240",2002,"25-29",232,112,120,
"240",2002,"30-34",322,151,171,
"240",2002,"35-39",388,184,204,
"240",2002,"40-44",507,266,241,
"240",2002,"45-49",587,315,272,
"240",2002,"50-54",492,265,227,
"240",2002,"55-59",315,173,142,
"240",2002,"60-64",296,182,114,
"240",2002,"65-69",178,97,81,
"240",2002,"70-74",111,56,55,
"240",2002,"75-79",68,40,28,
"240",2002,"80-84",35,13,22,
"240",2002,"85+",25,6,19,
"261",2002,"0-4",678,345,333,
"261",2002,"5-9",732,369,363,
"261",2002,"10-14",919,490,429,
"261",2002,"15-19",952,502,450,
"261",2002,"20-24",427,259,168,
"261",2002,"25-29",439,216,223,
"261",2002,"30-34",624,310,314,
"261",2002,"35-39",795,416,379,
"261",2002,"40-44",1036,539,497,
"261",2002,"45-49",1065,559,506,
"261",2002,"50-54",910,522,388,
"261",2002,"55-59",607,359,248,
"261",2002,"60-64",335,192,143,
"261",2002,"65-69",219,126,93,
"261",2002,"70-74",169,87,82,
"261",2002,"75-79",130,65,65,
"261",2002,"80-84",56,25,31,
"261",2002,"85+",47,19,28,
"270",2002,"0-4",776,424,352,
"270",2002,"5-9",833,434,399,
"270",2002,"10-14",1109,593,516,
"270",2002,"15-19",908,446,462,
"270",2002,"20-24",461,242,219,
"270",2002,"25-29",399,192,207,
"270",2002,"30-34",459,232,227,
"270",2002,"35-39",479,264,215,
"270",2002,"40-44",418,219,199,
"270",2002,"45-49",357,201,156,
"270",2002,"50-54",283,150,133,
"270",2002,"55-59",217,120,97,
"270",2002,"60-64",141,75,66,
"270",2002,"65-69",161,78,83,
"270",2002,"70-74",89,37,52,
"270",2002,"75-79",76,39,37,
"270",2002,"80-84",30,14,16,
"270",2002,"85+",20,7,13,
"275",2002,"0-4",144,78,66,
"275",2002,"5-9",164,85,79,
"275",2002,"10-14",211,113,98,
"275",2002,"15-19",187,102,85,
"275",2002,"20-24",84,47,37,
"275",2002,"25-29",73,35,38,
"275",2002,"30-34",113,49,64,
"275",2002,"35-39",154,73,81,
"275",2002,"40-44",210,104,106,
"275",2002,"45-49",238,128,110,
"275",2002,"50-54",199,107,92,
"275",2002,"55-59",156,81,75,
"275",2002,"60-64",132,76,56,
"275",2002,"65-69",93,52,41,
"275",2002,"70-74",75,39,36,
"275",2002,"75-79",56,27,29,
"275",2002,"80-84",38,18,20,
"275",2002,"85+",42,12,30,
"282",2002,"0-4",29,18,11,
"282",2002,"5-9",68,36,32,
"282",2002,"10-14",68,35,33,
"282",2002,"15-19",62,35,27,
"282",2002,"20-24",22,16,6,
"282",2002,"25-29",24,14,10,
"282",2002,"30-34",52,26,26,
"282",2002,"35-39",67,38,29,
"282",2002,"40-44",87,62,25,
"282",2002,"45-49",82,58,24,
"282",2002,"50-54",64,35,29,
"282",2002,"55-59",48,31,17,
"282",2002,"60-64",30,21,9,
"282",2002,"65-69",19,10,9,
"282",2002,"70-74",11,6,5,
"282",2002,"75-79",12,5,7,
"282",2002,"80-84",3,2,1,
"282",2002,"85+",2,2,0,
"290",2002,"0-4",441,234,207,
"290",2002,"5-9",502,250,252,
"290",2002,"10-14",750,406,344,
"290",2002,"15-19",726,389,337,
"290",2002,"20-24",337,214,123,
"290",2002,"25-29",279,170,109,
"290",2002,"30-34",329,158,171,
"290",2002,"35-39",474,252,222,
"290",2002,"40-44",509,258,251,
"290",2002,"45-49",514,295,219,
"290",2002,"50-54",479,266,213,
"290",2002,"55-59",320,189,131,
"290",2002,"60-64",216,116,100,
"290",2002,"65-69",163,91,72,
"290",2002,"70-74",134,73,61,
"290",2002,"75-79",86,46,40,
"290",2002,"80-84",49,24,25,
"290",2002,"85+",39,19,20,
"000",2003,"0-4",47991,24682,23309,
"000",2003,"5-9",49039,24978,24061,
"000",2003,"10-14",57267,29379,27888,
"000",2003,"15-19",55046,28507,26539,
"000",2003,"20-24",43553,23750,19803,
"000",2003,"25-29",41389,21635,19754,
"000",2003,"30-34",47146,24236,22910,
"000",2003,"35-39",49959,25849,24110,
"000",2003,"40-44",57286,29172,28114,
"000",2003,"45-49",57362,29514,27848,
"000",2003,"50-54",48536,25872,22664,
"000",2003,"55-59",34049,18291,15758,
"000",2003,"60-64",21435,11450,9985,
"000",2003,"65-69",13770,7119,6651,
"000",2003,"70-74",10347,5031,5316,
"000",2003,"75-79",7459,3439,4020,
"000",2003,"80-84",4518,1886,2632,
"000",2003,"85+",3314,1115,2199,
"013",2003,"0-4",81,40,41,
"013",2003,"5-9",129,64,65,
"013",2003,"10-14",104,52,52,
"013",2003,"15-19",123,61,62,
"013",2003,"20-24",201,148,53,
"013",2003,"25-29",223,144,79,
"013",2003,"30-34",203,141,62,
"013",2003,"35-39",341,246,95,
"013",2003,"40-44",360,258,102,
"013",2003,"45-49",316,209,107,
"013",2003,"50-54",282,170,112,
"013",2003,"55-59",195,123,72,
"013",2003,"60-64",86,53,33,
"013",2003,"65-69",43,28,15,
"013",2003,"70-74",10,8,2,
"013",2003,"75-79",12,8,4,
"013",2003,"80-84",11,7,4,
"013",2003,"85+",6,3,3,
"016",2003,"0-4",200,96,104,
"016",2003,"5-9",271,133,138,
"016",2003,"10-14",248,142,106,
"016",2003,"15-19",269,132,137,
"016",2003,"20-24",257,167,90,
"016",2003,"25-29",448,300,148,
"016",2003,"30-34",621,435,186,
"016",2003,"35-39",742,522,220,
"016",2003,"40-44",673,448,225,
"016",2003,"45-49",623,449,174,
"016",2003,"50-54",506,330,176,
"016",2003,"55-59",303,192,111,
"016",2003,"60-64",145,94,51,
"016",2003,"65-69",70,32,38,
"016",2003,"70-74",21,11,10,
"016",2003,"75-79",17,7,10,
"016",2003,"80-84",11,3,8,
"016",2003,"85+",5,0,5,
"020",2003,"0-4",20475,10483,9992,
"020",2003,"5-9",20457,10383,10074,
"020",2003,"10-14",22560,11509,11051,
"020",2003,"15-19",21017,10820,10197,
"020",2003,"20-24",19588,10309,9279,
"020",2003,"25-29",19780,10254,9526,
"020",2003,"30-34",21611,10985,10626,
"020",2003,"35-39",21672,10910,10762,
"020",2003,"40-44",24236,12065,12171,
"020",2003,"45-49",23463,11632,11831,
"020",2003,"50-54",19522,10108,9414,
"020",2003,"55-59",13971,7284,6687,
"020",2003,"60-64",8463,4339,4124,
"020",2003,"65-69",5265,2581,2684,
"020",2003,"70-74",4052,1858,2194,
"020",2003,"75-79",2998,1273,1725,
"020",2003,"80-84",1830,726,1104,
"020",2003,"85+",1344,420,924,
"050",2003,"0-4",1792,941,851,
"050",2003,"5-9",1653,911,742,
"050",2003,"10-14",1994,1024,970,
"050",2003,"15-19",1744,933,811,
"050",2003,"20-24",1110,570,540,
"050",2003,"25-29",960,488,472,
"050",2003,"30-34",1062,546,516,
"050",2003,"35-39",1234,674,560,
"050",2003,"40-44",1236,679,557,
"050",2003,"45-49",1033,574,459,
"050",2003,"50-54",920,517,403,
"050",2003,"55-59",590,317,273,
"050",2003,"60-64",436,228,208,
"050",2003,"65-69",300,146,154,
"050",2003,"70-74",246,126,120,
"050",2003,"75-79",144,75,69,
"050",2003,"80-84",105,49,56,
"050",2003,"85+",81,29,52,
"060",2003,"0-4",67,35,32,
"060",2003,"5-9",82,40,42,
"060",2003,"10-14",116,59,57,
"060",2003,"15-19",102,57,45,
"060",2003,"20-24",33,14,19,
"060",2003,"25-29",33,23,10,
"060",2003,"30-34",59,34,25,
"060",2003,"35-39",82,41,41,
"060",2003,"40-44",167,93,74,
"060",2003,"45-49",118,65,53,
"060",2003,"50-54",99,54,45,
"060",2003,"55-59",70,46,24,
"060",2003,"60-64",30,18,12,
"060",2003,"65-69",24,13,11,
"060",2003,"70-74",15,11,4,
"060",2003,"75-79",8,5,3,
"060",2003,"80-84",5,1,4,
"060",2003,"85+",3,3,0,
"068",2003,"0-4",105,61,44,
"068",2003,"5-9",106,49,57,
"068",2003,"10-14",131,76,55,
"068",2003,"15-19",144,76,68,
"068",2003,"20-24",65,40,25,
"068",2003,"25-29",108,66,42,
"068",2003,"30-34",154,86,68,
"068",2003,"35-39",162,97,65,
"068",2003,"40-44",205,111,94,
"068",2003,"45-49",230,141,89,
"068",2003,"50-54",209,123,86,
"068",2003,"55-59",111,62,49,
"068",2003,"60-64",86,65,21,
"068",2003,"65-69",31,16,15,
"068",2003,"70-74",16,11,5,
"068",2003,"75-79",9,7,2,
"068",2003,"80-84",4,2,2,
"068",2003,"85+",6,3,3,
"070",2003,"0-4",430,224,206,
"070",2003,"5-9",490,261,229,
"070",2003,"10-14",574,304,270,
"070",2003,"15-19",526,270,256,
"070",2003,"20-24",249,141,108,
"070",2003,"25-29",225,107,118,
"070",2003,"30-34",286,149,137,
"070",2003,"35-39",365,189,176,
"070",2003,"40-44",393,202,191,
"070",2003,"45-49",387,210,177,
"070",2003,"50-54",328,165,163,
"070",2003,"55-59",204,106,98,
"070",2003,"60-64",158,84,74,
"070",2003,"65-69",90,45,45,
"070",2003,"70-74",89,51,38,
"070",2003,"75-79",53,26,27,
"070",2003,"80-84",22,12,10,
"070",2003,"85+",25,10,15,
"090",2003,"0-4",6880,3500,3380,
"090",2003,"5-9",6117,3076,3041,
"090",2003,"10-14",6799,3467,3332,
"090",2003,"15-19",6680,3489,3191,
"090",2003,"20-24",7468,4289,3179,
"090",2003,"25-29",7617,4171,3446,
"090",2003,"30-34",6401,3331,3070,
"090",2003,"35-39",6047,3140,2907,
"090",2003,"40-44",6627,3267,3360,
"090",2003,"45-49",6576,3256,3320,
"090",2003,"50-54",5808,3195,2613,
"090",2003,"55-59",3978,2170,1808,
"090",2003,"60-64",2432,1287,1145,
"090",2003,"65-69",1502,815,687,
"090",2003,"70-74",1136,576,560,
"090",2003,"75-79",752,341,411,
"090",2003,"80-84",539,227,312,
"090",2003,"85+",355,116,239,
"100",2003,"0-4",107,49,58,
"100",2003,"5-9",146,74,72,
"100",2003,"10-14",170,86,84,
"100",2003,"15-19",197,100,97,
"100",2003,"20-24",85,45,40,
"100",2003,"25-29",66,32,34,
"100",2003,"30-34",130,61,69,
"100",2003,"35-39",165,85,80,
"100",2003,"40-44",192,95,97,
"100",2003,"45-49",272,147,125,
"100",2003,"50-54",272,145,127,
"100",2003,"55-59",206,97,109,
"100",2003,"60-64",106,56,50,
"100",2003,"65-69",89,48,41,
"100",2003,"70-74",68,32,36,
"100",2003,"75-79",58,35,23,
"100",2003,"80-84",32,16,16,
"100",2003,"85+",30,13,17,
"105",2003,"0-4",103,55,48,
"105",2003,"5-9",146,76,70,
"105",2003,"10-14",196,103,93,
"105",2003,"15-19",202,99,103,
"105",2003,"20-24",125,71,54,
"105",2003,"25-29",71,40,31,
"105",2003,"30-34",98,60,38,
"105",2003,"35-39",153,86,67,
"105",2003,"40-44",212,111,101,
"105",2003,"45-49",218,121,97,
"105",2003,"50-54",221,117,104,
"105",2003,"55-59",186,110,76,
"105",2003,"60-64",124,75,49,
"105",2003,"65-69",90,56,34,
"105",2003,"70-74",47,32,15,
"105",2003,"75-79",34,18,16,
"105",2003,"80-84",20,10,10,
"105",2003,"85+",17,3,14,
"110",2003,"0-4",2052,1055,997,
"110",2003,"5-9",2086,1055,1031,
"110",2003,"10-14",2553,1266,1287,
"110",2003,"15-19",2537,1346,1191,
"110",2003,"20-24",1798,933,865,
"110",2003,"25-29",1776,823,953,
"110",2003,"30-34",2275,1196,1079,
"110",2003,"35-39",2516,1278,1238,
"110",2003,"40-44",2892,1418,1474,
"110",2003,"45-49",3081,1545,1536,
"110",2003,"50-54",2861,1467,1394,
"110",2003,"55-59",1906,1022,884,
"110",2003,"60-64",1044,535,509,
"110",2003,"65-69",642,334,308,
"110",2003,"70-74",479,223,256,
"110",2003,"75-79",368,152,216,
"110",2003,"80-84",274,103,171,
"110",2003,"85+",224,83,141,
"122",2003,"0-4",3232,1604,1628,
"122",2003,"5-9",3563,1831,1732,
"122",2003,"10-14",4563,2307,2256,
"122",2003,"15-19",4758,2487,2271,
"122",2003,"20-24",2658,1552,1106,
"122",2003,"25-29",1980,1029,951,
"122",2003,"30-34",3172,1612,1560,
"122",2003,"35-39",3511,1826,1685,
"122",2003,"40-44",4698,2409,2289,
"122",2003,"45-49",5306,2702,2604,
"122",2003,"50-54",4549,2454,2095,
"122",2003,"55-59",3272,1795,1477,
"122",2003,"60-64",2251,1201,1050,
"122",2003,"65-69",1490,793,697,
"122",2003,"70-74",1129,561,568,
"122",2003,"75-79",837,427,410,
"122",2003,"80-84",476,211,265,
"122",2003,"85+",298,106,192,
"130",2003,"0-4",867,448,419,
"130",2003,"5-9",982,506,476,
"130",2003,"10-14",1154,580,574,
"130",2003,"15-19",1076,546,530,
"130",2003,"20-24",725,394,331,
"130",2003,"25-29",620,319,301,
"130",2003,"30-34",927,444,483,
"130",2003,"35-39",1053,553,500,
"130",2003,"40-44",1313,689,624,
"130",2003,"45-49",1266,641,625,
"130",2003,"50-54",1104,591,513,
"130",2003,"55-59",902,464,438,
"130",2003,"60-64",550,300,250,
"130",2003,"65-69",330,187,143,
"130",2003,"70-74",285,121,164,
"130",2003,"75-79",236,116,120,
"130",2003,"80-84",130,48,82,
"130",2003,"85+",131,51,80,
"150",2003,"0-4",1181,610,571,
"150",2003,"5-9",1164,582,582,
"150",2003,"10-14",1311,664,647,
"150",2003,"15-19",1130,601,529,
"150",2003,"20-24",744,418,326,
"150",2003,"25-29",823,458,365,
"150",2003,"30-34",1052,560,492,
"150",2003,"35-39",1201,626,575,
"150",2003,"40-44",1261,679,582,
"150",2003,"45-49",1153,642,511,
"150",2003,"50-54",942,507,435,
"150",2003,"55-59",646,352,294,
"150",2003,"60-64",379,202,177,
"150",2003,"65-69",279,145,134,
"150",2003,"70-74",185,104,81,
"150",2003,"75-79",114,51,63,
"150",2003,"80-84",67,35,32,
"150",2003,"85+",59,24,35,
"164",2003,"0-4",99,48,51,
"164",2003,"5-9",158,78,80,
"164",2003,"10-14",204,106,98,
"164",2003,"15-19",191,94,97,
"164",2003,"20-24",113,65,48,
"164",2003,"25-29",49,21,28,
"164",2003,"30-34",65,37,28,
"164",2003,"35-39",116,65,51,
"164",2003,"40-44",164,96,68,
"164",2003,"45-49",147,79,68,
"164",2003,"50-54",112,61,51,
"164",2003,"55-59",60,36,24,
"164",2003,"60-64",62,32,30,
"164",2003,"65-69",36,24,12,
"164",2003,"70-74",34,18,16,
"164",2003,"75-79",16,12,4,
"164",2003,"80-84",11,5,6,
"164",2003,"85+",6,0,6,
"170",2003,"0-4",4194,2166,2028,
"170",2003,"5-9",5308,2695,2613,
"170",2003,"10-14",6609,3456,3153,
"170",2003,"15-19",6758,3518,3240,
"170",2003,"20-24",3784,2044,1740,
"170",2003,"25-29",2914,1428,1486,
"170",2003,"30-34",4331,2162,2169,
"170",2003,"35-39",5145,2590,2555,
"170",2003,"40-44",6571,3313,3258,
"170",2003,"45-49",6732,3584,3148,
"170",2003,"50-54",5305,2809,2496,
"170",2003,"55-59",3472,1888,1584,
"170",2003,"60-64",2431,1351,1080,
"170",2003,"65-69",1626,839,787,
"170",2003,"70-74",1235,632,603,
"170",2003,"75-79",796,400,396,
"170",2003,"80-84",449,193,256,
"170",2003,"85+",303,104,199,
"180",2003,"0-4",916,497,419,
"180",2003,"5-9",789,414,375,
"180",2003,"10-14",1103,568,535,
"180",2003,"15-19",959,496,463,
"180",2003,"20-24",599,335,264,
"180",2003,"25-29",600,320,280,
"180",2003,"30-34",610,323,287,
"180",2003,"35-39",646,376,270,
"180",2003,"40-44",711,402,309,
"180",2003,"45-49",662,362,300,
"180",2003,"50-54",560,335,225,
"180",2003,"55-59",398,216,182,
"180",2003,"60-64",258,142,116,
"180",2003,"65-69",190,112,78,
"180",2003,"70-74",130,66,64,
"180",2003,"75-79",113,50,63,
"180",2003,"80-84",49,25,24,
"180",2003,"85+",49,17,32,
"185",2003,"0-4",702,385,317,
"185",2003,"5-9",652,346,306,
"185",2003,"10-14",806,403,403,
"185",2003,"15-19",812,433,379,
"185",2003,"20-24",494,251,243,
"185",2003,"25-29",373,193,180,
"185",2003,"30-34",455,253,202,
"185",2003,"35-39",581,317,264,
"185",2003,"40-44",535,284,251,
"185",2003,"45-49",571,309,262,
"185",2003,"50-54",423,244,179,
"185",2003,"55-59",303,175,128,
"185",2003,"60-64",183,96,87,
"185",2003,"65-69",131,71,60,
"185",2003,"70-74",72,32,40,
"185",2003,"75-79",47,18,29,
"185",2003,"80-84",39,15,24,
"185",2003,"85+",19,3,16,
"188",2003,"0-4",745,385,360,
"188",2003,"5-9",729,362,367,
"188",2003,"10-14",907,486,421,
"188",2003,"15-19",797,397,400,
"188",2003,"20-24",571,301,270,
"188",2003,"25-29",422,235,187,
"188",2003,"30-34",466,258,208,
"188",2003,"35-39",512,275,237,
"188",2003,"40-44",499,281,218,
"188",2003,"45-49",482,295,187,
"188",2003,"50-54",376,212,164,
"188",2003,"55-59",267,150,117,
"188",2003,"60-64",157,87,70,
"188",2003,"65-69",113,62,51,
"188",2003,"70-74",122,57,65,
"188",2003,"75-79",81,37,44,
"188",2003,"80-84",30,9,21,
"188",2003,"85+",27,13,14,
"195",2003,"0-4",262,139,123,
"195",2003,"5-9",308,158,150,
"195",2003,"10-14",363,185,178,
"195",2003,"15-19",350,183,167,
"195",2003,"20-24",189,106,83,
"195",2003,"25-29",169,86,83,
"195",2003,"30-34",266,142,124,
"195",2003,"35-39",312,163,149,
"195",2003,"40-44",342,168,174,
"195",2003,"45-49",410,212,198,
"195",2003,"50-54",341,189,152,
"195",2003,"55-59",266,146,120,
"195",2003,"60-64",170,96,74,
"195",2003,"65-69",106,61,45,
"195",2003,"70-74",78,40,38,
"195",2003,"75-79",84,40,44,
"195",2003,"80-84",58,27,31,
"195",2003,"85+",41,18,23,
"198",2003,"0-4",380,202,178,
"198",2003,"5-9",448,235,213,
"198",2003,"10-14",490,259,231,
"198",2003,"15-19",476,251,225,
"198",2003,"20-24",316,181,135,
"198",2003,"25-29",209,115,94,
"198",2003,"30-34",313,156,157,
"198",2003,"35-39",405,207,198,
"198",2003,"40-44",516,279,237,
"198",2003,"45-49",551,318,233,
"198",2003,"50-54",478,276,202,
"198",2003,"55-59",370,215,155,
"198",2003,"60-64",262,159,103,
"198",2003,"65-69",163,103,60,
"198",2003,"70-74",102,65,37,
"198",2003,"75-79",71,38,33,
"198",2003,"80-84",35,15,20,
"198",2003,"85+",14,5,9,
"220",2003,"0-4",625,356,269,
"220",2003,"5-9",573,287,286,
"220",2003,"10-14",700,357,343,
"220",2003,"15-19",678,321,357,
"220",2003,"20-24",599,349,250,
"220",2003,"25-29",509,254,255,
"220",2003,"30-34",606,298,308,
"220",2003,"35-39",678,363,315,
"220",2003,"40-44",747,388,359,
"220",2003,"45-49",813,403,410,
"220",2003,"50-54",712,369,343,
"220",2003,"55-59",492,257,235,
"220",2003,"60-64",365,212,153,
"220",2003,"65-69",293,135,158,
"220",2003,"70-74",202,98,104,
"220",2003,"75-79",145,64,81,
"220",2003,"80-84",84,35,49,
"220",2003,"85+",97,27,70,
"230",2003,"0-4",32,15,17,
"230",2003,"5-9",47,21,26,
"230",2003,"10-14",53,26,27,
"230",2003,"15-19",33,19,14,
"230",2003,"20-24",30,16,14,
"230",2003,"25-29",63,31,32,
"230",2003,"30-34",92,44,48,
"230",2003,"35-39",71,43,28,
"230",2003,"40-44",78,44,34,
"230",2003,"45-49",83,48,35,
"230",2003,"50-54",94,54,40,
"230",2003,"55-59",72,33,39,
"230",2003,"60-64",47,24,23,
"230",2003,"65-69",24,15,9,
"230",2003,"70-74",19,10,9,
"230",2003,"75-79",14,5,9,
"230",2003,"80-84",9,4,5,
"230",2003,"85+",7,3,4,
"240",2003,"0-4",327,162,165,
"240",2003,"5-9",471,236,235,
"240",2003,"10-14",556,270,286,
"240",2003,"15-19",600,300,300,
"240",2003,"20-24",256,154,102,
"240",2003,"25-29",191,86,105,
"240",2003,"30-34",348,170,178,
"240",2003,"35-39",361,167,194,
"240",2003,"40-44",477,261,216,
"240",2003,"45-49",582,303,279,
"240",2003,"50-54",505,272,233,
"240",2003,"55-59",348,199,149,
"240",2003,"60-64",308,188,120,
"240",2003,"65-69",188,109,79,
"240",2003,"70-74",109,54,55,
"240",2003,"75-79",80,45,35,
"240",2003,"80-84",32,13,19,
"240",2003,"85+",27,5,22,
"261",2003,"0-4",702,354,348,
"261",2003,"5-9",710,357,353,
"261",2003,"10-14",895,492,403,
"261",2003,"15-19",981,500,481,
"261",2003,"20-24",504,294,210,
"261",2003,"25-29",424,226,198,
"261",2003,"30-34",617,292,325,
"261",2003,"35-39",790,421,369,
"261",2003,"40-44",1002,514,488,
"261",2003,"45-49",1079,574,505,
"261",2003,"50-54",943,528,415,
"261",2003,"55-59",665,390,275,
"261",2003,"60-64",375,230,145,
"261",2003,"65-69",218,118,100,
"261",2003,"70-74",153,77,76,
"261",2003,"75-79",137,71,66,
"261",2003,"80-84",60,26,34,
"261",2003,"85+",43,16,27,
"270",2003,"0-4",824,450,374,
"270",2003,"5-9",773,402,371,
"270",2003,"10-14",1102,585,517,
"270",2003,"15-19",950,471,479,
"270",2003,"20-24",492,264,228,
"270",2003,"25-29",385,173,212,
"270",2003,"30-34",450,233,217,
"270",2003,"35-39",451,239,212,
"270",2003,"40-44",426,232,194,
"270",2003,"45-49",391,224,167,
"270",2003,"50-54",281,149,132,
"270",2003,"55-59",228,122,106,
"270",2003,"60-64",150,83,67,
"270",2003,"65-69",149,70,79,
"270",2003,"70-74",103,46,57,
"270",2003,"75-79",62,27,35,
"270",2003,"80-84",43,24,19,
"270",2003,"85+",16,5,11,
"275",2003,"0-4",136,70,66,
"275",2003,"5-9",159,83,76,
"275",2003,"10-14",199,106,93,
"275",2003,"15-19",197,108,89,
"275",2003,"20-24",87,48,39,
"275",2003,"25-29",62,31,31,
"275",2003,"30-34",105,44,61,
"275",2003,"35-39",145,69,76,
"275",2003,"40-44",194,94,100,
"275",2003,"45-49",241,129,112,
"275",2003,"50-54",211,115,96,
"275",2003,"55-59",164,85,79,
"275",2003,"60-64",138,79,59,
"275",2003,"65-69",99,57,42,
"275",2003,"70-74",75,39,36,
"275",2003,"75-79",59,29,30,
"275",2003,"80-84",37,17,20,
"275",2003,"85+",41,15,26,
"282",2003,"0-4",29,13,16,
"282",2003,"5-9",51,28,23,
"282",2003,"10-14",81,46,35,
"282",2003,"15-19",54,32,22,
"282",2003,"20-24",29,16,13,
"282",2003,"25-29",19,13,6,
"282",2003,"30-34",50,26,24,
"282",2003,"35-39",69,39,30,
"282",2003,"40-44",73,54,19,
"282",2003,"45-49",81,57,24,
"282",2003,"50-54",67,39,28,
"282",2003,"55-59",47,29,18,
"282",2003,"60-64",30,23,7,
"282",2003,"65-69",20,10,10,
"282",2003,"70-74",11,4,7,
"282",2003,"75-79",14,8,6,
"282",2003,"80-84",4,1,3,
"282",2003,"85+",3,1,2,
"290",2003,"0-4",446,239,207,
"290",2003,"5-9",471,235,236,
"290",2003,"10-14",726,395,331,
"290",2003,"15-19",705,367,338,
"290",2003,"20-24",384,235,149,
"290",2003,"25-29",270,169,101,
"290",2003,"30-34",321,158,163,
"290",2003,"35-39",433,242,191,
"290",2003,"40-44",486,238,248,
"290",2003,"45-49",495,283,212,
"290",2003,"50-54",505,277,228,
"290",2003,"55-59",357,210,147,
"290",2003,"60-64",209,111,98,
"290",2003,"65-69",169,94,75,
"290",2003,"70-74",124,68,56,
"290",2003,"75-79",100,54,46,
"290",2003,"80-84",52,27,25,
"290",2003,"85+",37,19,18,
"000",2004,"0-4",48843,25161,23682,
"000",2004,"5-9",48495,24728,23767,
"000",2004,"10-14",56792,29053,27739,
"000",2004,"15-19",55565,28704,26861,
"000",2004,"20-24",46292,25246,21046,
"000",2004,"25-29",42074,22212,19862,
"000",2004,"30-34",47143,24120,23023,
"000",2004,"35-39",48520,24985,23535,
"000",2004,"40-44",57102,29261,27841,
"000",2004,"45-49",57527,29422,28105,
"000",2004,"50-54",50599,26867,23732,
"000",2004,"55-59",36598,19658,16940,
"000",2004,"60-64",23249,12407,10842,
"000",2004,"65-69",14370,7482,6888,
"000",2004,"70-74",10468,5086,5382,
"000",2004,"75-79",7713,3586,4127,
"000",2004,"80-84",4809,1999,2810,
"000",2004,"85+",3494,1187,2307,
"013",2004,"0-4",73,34,39,
"013",2004,"5-9",110,49,61,
"013",2004,"10-14",85,39,46,
"013",2004,"15-19",110,58,52,
"013",2004,"20-24",200,146,54,
"013",2004,"25-29",234,152,82,
"013",2004,"30-34",182,121,61,
"013",2004,"35-39",302,228,74,
"013",2004,"40-44",378,271,107,
"013",2004,"45-49",317,207,110,
"013",2004,"50-54",295,183,112,
"013",2004,"55-59",209,137,72,
"013",2004,"60-64",92,57,35,
"013",2004,"65-69",46,28,18,
"013",2004,"70-74",9,6,3,
"013",2004,"75-79",12,7,5,
"013",2004,"80-84",12,9,3,
"013",2004,"85+",5,2,3,
"016",2004,"0-4",189,86,103,
"016",2004,"5-9",255,125,130,
"016",2004,"10-14",239,135,104,
"016",2004,"15-19",256,136,120,
"016",2004,"20-24",265,158,107,
"016",2004,"25-29",447,312,135,
"016",2004,"30-34",561,397,164,
"016",2004,"35-39",718,499,219,
"016",2004,"40-44",676,459,217,
"016",2004,"45-49",622,440,182,
"016",2004,"50-54",535,353,182,
"016",2004,"55-59",322,204,118,
"016",2004,"60-64",147,96,51,
"016",2004,"65-69",86,42,44,
"016",2004,"70-74",22,15,7,
"016",2004,"75-79",15,7,8,
"016",2004,"80-84",10,4,6,
"016",2004,"85+",5,0,5,
"020",2004,"0-4",20814,10714,10100,
"020",2004,"5-9",20307,10266,10041,
"020",2004,"10-14",22688,11588,11100,
"020",2004,"15-19",21249,10921,10328,
"020",2004,"20-24",20593,10846,9747,
"020",2004,"25-29",20349,10658,9691,
"020",2004,"30-34",21692,10987,10705,
"020",2004,"35-39",21021,10515,10506,
"020",2004,"40-44",24284,12256,12028,
"020",2004,"45-49",23571,11537,12034,
"020",2004,"50-54",20247,10467,9780,
"020",2004,"55-59",14850,7738,7112,
"020",2004,"60-64",9230,4733,4497,
"020",2004,"65-69",5472,2710,2762,
"020",2004,"70-74",4041,1837,2204,
"020",2004,"75-79",3062,1313,1749,
"020",2004,"80-84",1982,780,1202,
"020",2004,"85+",1413,450,963,
"050",2004,"0-4",1873,977,896,
"050",2004,"5-9",1565,870,695,
"050",2004,"10-14",1994,1022,972,
"050",2004,"15-19",1718,915,803,
"050",2004,"20-24",1189,621,568,
"050",2004,"25-29",972,492,480,
"050",2004,"30-34",1033,528,505,
"050",2004,"35-39",1165,633,532,
"050",2004,"40-44",1261,689,572,
"050",2004,"45-49",1061,582,479,
"050",2004,"50-54",928,538,390,
"050",2004,"55-59",630,337,293,
"050",2004,"60-64",484,253,231,
"050",2004,"65-69",275,137,138,
"050",2004,"70-74",243,123,120,
"050",2004,"75-79",154,78,76,
"050",2004,"80-84",97,44,53,
"050",2004,"85+",94,39,55,
"060",2004,"0-4",71,43,28,
"060",2004,"5-9",84,39,45,
"060",2004,"10-14",100,50,50,
"060",2004,"15-19",103,59,44,
"060",2004,"20-24",46,19,27,
"060",2004,"25-29",31,23,8,
"060",2004,"30-34",63,35,28,
"060",2004,"35-39",72,35,37,
"060",2004,"40-44",149,81,68,
"060",2004,"45-49",129,74,55,
"060",2004,"50-54",92,48,44,
"060",2004,"55-59",83,52,31,
"060",2004,"60-64",25,15,10,
"060",2004,"65-69",33,17,16,
"060",2004,"70-74",15,10,5,
"060",2004,"75-79",10,7,3,
"060",2004,"80-84",5,1,4,
"060",2004,"85+",3,3,0,
"068",2004,"0-4",98,52,46,
"068",2004,"5-9",101,54,47,
"068",2004,"10-14",124,71,53,
"068",2004,"15-19",134,72,62,
"068",2004,"20-24",61,37,24,
"068",2004,"25-29",89,55,34,
"068",2004,"30-34",142,76,66,
"068",2004,"35-39",143,88,55,
"068",2004,"40-44",199,106,93,
"068",2004,"45-49",228,141,87,
"068",2004,"50-54",203,123,80,
"068",2004,"55-59",124,71,53,
"068",2004,"60-64",89,64,25,
"068",2004,"65-69",37,20,17,
"068",2004,"70-74",15,12,3,
"068",2004,"75-79",10,6,4,
"068",2004,"80-84",3,2,1,
"068",2004,"85+",6,3,3,
"070",2004,"0-4",422,218,204,
"070",2004,"5-9",469,256,213,
"070",2004,"10-14",542,287,255,
"070",2004,"15-19",540,272,268,
"070",2004,"20-24",269,152,117,
"070",2004,"25-29",207,98,109,
"070",2004,"30-34",270,142,128,
"070",2004,"35-39",343,173,170,
"070",2004,"40-44",382,207,175,
"070",2004,"45-49",389,202,187,
"070",2004,"50-54",350,180,170,
"070",2004,"55-59",206,104,102,
"070",2004,"60-64",160,84,76,
"070",2004,"65-69",95,50,45,
"070",2004,"70-74",78,47,31,
"070",2004,"75-79",66,32,34,
"070",2004,"80-84",22,13,9,
"070",2004,"85+",29,12,17,
"090",2004,"0-4",7208,3669,3539,
"090",2004,"5-9",6317,3188,3129,
"090",2004,"10-14",6892,3478,3414,
"090",2004,"15-19",6960,3625,3335,
"090",2004,"20-24",7807,4472,3335,
"090",2004,"25-29",8222,4517,3705,
"090",2004,"30-34",6723,3495,3228,
"090",2004,"35-39",6085,3113,2972,
"090",2004,"40-44",6812,3382,3430,
"090",2004,"45-49",6763,3357,3406,
"090",2004,"50-54",6135,3312,2823,
"090",2004,"55-59",4395,2409,1986,
"090",2004,"60-64",2726,1460,1266,
"090",2004,"65-69",1576,850,726,
"090",2004,"70-74",1172,561,611,
"090",2004,"75-79",804,390,414,
"090",2004,"80-84",557,231,326,
"090",2004,"85+",401,135,266,
"100",2004,"0-4",101,45,56,
"100",2004,"5-9",143,72,71,
"100",2004,"10-14",162,85,77,
"100",2004,"15-19",184,95,89,
"100",2004,"20-24",87,47,40,
"100",2004,"25-29",54,22,32,
"100",2004,"30-34",105,49,56,
"100",2004,"35-39",170,86,84,
"100",2004,"40-44",188,91,97,
"100",2004,"45-49",262,138,124,
"100",2004,"50-54",257,145,112,
"100",2004,"55-59",228,112,116,
"100",2004,"60-64",128,63,65,
"100",2004,"65-69",83,47,36,
"100",2004,"70-74",76,36,40,
"100",2004,"75-79",52,30,22,
"100",2004,"80-84",37,19,18,
"100",2004,"85+",26,9,17,
"105",2004,"0-4",105,58,47,
"105",2004,"5-9",129,63,66,
"105",2004,"10-14",184,101,83,
"105",2004,"15-19",196,93,103,
"105",2004,"20-24",128,74,54,
"105",2004,"25-29",62,35,27,
"105",2004,"30-34",89,53,36,
"105",2004,"35-39",132,79,53,
"105",2004,"40-44",206,105,101,
"105",2004,"45-49",210,120,90,
"105",2004,"50-54",221,114,107,
"105",2004,"55-59",200,118,82,
"105",2004,"60-64",127,77,50,
"105",2004,"65-69",98,59,39,
"105",2004,"70-74",49,36,13,
"105",2004,"75-79",33,17,16,
"105",2004,"80-84",20,11,9,
"105",2004,"85+",16,3,13,
"110",2004,"0-4",2011,1042,969,
"110",2004,"5-9",2036,1034,1002,
"110",2004,"10-14",2460,1208,1252,
"110",2004,"15-19",2524,1328,1196,
"110",2004,"20-24",1895,996,899,
"110",2004,"25-29",1700,797,903,
"110",2004,"30-34",2167,1107,1060,
"110",2004,"35-39",2478,1294,1184,
"110",2004,"40-44",2819,1373,1446,
"110",2004,"45-49",3006,1533,1473,
"110",2004,"50-54",2905,1477,1428,
"110",2004,"55-59",2065,1086,979,
"110",2004,"60-64",1111,580,531,
"110",2004,"65-69",687,354,333,
"110",2004,"70-74",467,224,243,
"110",2004,"75-79",387,155,232,
"110",2004,"80-84",267,103,164,
"110",2004,"85+",228,81,147,
"122",2004,"0-4",3174,1597,1577,
"122",2004,"5-9",3427,1730,1697,
"122",2004,"10-14",4398,2261,2137,
"122",2004,"15-19",4675,2394,2281,
"122",2004,"20-24",2920,1696,1224,
"122",2004,"25-29",1753,930,823,
"122",2004,"30-34",3066,1568,1498,
"122",2004,"35-39",3308,1717,1591,
"122",2004,"40-44",4561,2327,2234,
"122",2004,"45-49",5100,2620,2480,
"122",2004,"50-54",4849,2579,2270,
"122",2004,"55-59",3495,1908,1587,
"122",2004,"60-64",2435,1307,1128,
"122",2004,"65-69",1575,846,729,
"122",2004,"70-74",1153,590,563,
"122",2004,"75-79",891,453,438,
"122",2004,"80-84",507,223,284,
"122",2004,"85+",329,115,214,
"130",2004,"0-4",815,425,390,
"130",2004,"5-9",920,465,455,
"130",2004,"10-14",1096,555,541,
"130",2004,"15-19",1028,537,491,
"130",2004,"20-24",762,405,357,
"130",2004,"25-29",582,296,286,
"130",2004,"30-34",857,422,435,
"130",2004,"35-39",952,489,463,
"130",2004,"40-44",1254,672,582,
"130",2004,"45-49",1230,608,622,
"130",2004,"50-54",1114,593,521,
"130",2004,"55-59",932,484,448,
"130",2004,"60-64",580,311,269,
"130",2004,"65-69",353,200,153,
"130",2004,"70-74",259,118,141,
"130",2004,"75-79",230,107,123,
"130",2004,"80-84",150,60,90,
"130",2004,"85+",128,50,78,
"150",2004,"0-4",1112,569,543,
"150",2004,"5-9",1160,592,568,
"150",2004,"10-14",1218,610,608,
"150",2004,"15-19",1143,612,531,
"150",2004,"20-24",755,440,315,
"150",2004,"25-29",791,430,361,
"150",2004,"30-34",988,525,463,
"150",2004,"35-39",1118,592,526,
"150",2004,"40-44",1251,664,587,
"150",2004,"45-49",1108,613,495,
"150",2004,"50-54",970,525,445,
"150",2004,"55-59",665,358,307,
"150",2004,"60-64",414,221,193,
"150",2004,"65-69",285,151,134,
"150",2004,"70-74",194,104,90,
"150",2004,"75-79",110,50,60,
"150",2004,"80-84",66,33,33,
"150",2004,"85+",63,27,36,
"164",2004,"0-4",97,47,50,
"164",2004,"5-9",157,72,85,
"164",2004,"10-14",194,105,89,
"164",2004,"15-19",179,87,92,
"164",2004,"20-24",135,76,59,
"164",2004,"25-29",44,22,22,
"164",2004,"30-34",67,34,33,
"164",2004,"35-39",108,63,45,
"164",2004,"40-44",155,91,64,
"164",2004,"45-49",144,80,64,
"164",2004,"50-54",124,64,60,
"164",2004,"55-59",55,35,20,
"164",2004,"60-64",71,37,34,
"164",2004,"65-69",37,26,11,
"164",2004,"70-74",30,16,14,
"164",2004,"75-79",19,12,7,
"164",2004,"80-84",10,5,5,
"164",2004,"85+",6,0,6,
"170",2004,"0-4",4539,2343,2196,
"170",2004,"5-9",5377,2758,2619,
"170",2004,"10-14",6707,3429,3278,
"170",2004,"15-19",6905,3612,3293,
"170",2004,"20-24",4334,2365,1969,
"170",2004,"25-29",2964,1477,1487,
"170",2004,"30-34",4523,2243,2280,
"170",2004,"35-39",5148,2562,2586,
"170",2004,"40-44",6604,3338,3266,
"170",2004,"45-49",6948,3672,3276,
"170",2004,"50-54",5744,3019,2725,
"170",2004,"55-59",3839,2108,1731,
"170",2004,"60-64",2686,1466,1220,
"170",2004,"65-69",1725,889,836,
"170",2004,"70-74",1321,676,645,
"170",2004,"75-79",850,434,416,
"170",2004,"80-84",481,208,273,
"170",2004,"85+",344,121,223,
"180",2004,"0-4",944,506,438,
"180",2004,"5-9",729,392,337,
"180",2004,"10-14",1112,576,536,
"180",2004,"15-19",971,494,477,
"180",2004,"20-24",652,357,295,
"180",2004,"25-29",569,309,260,
"180",2004,"30-34",657,347,310,
"180",2004,"35-39",605,349,256,
"180",2004,"40-44",715,401,314,
"180",2004,"45-49",647,363,284,
"180",2004,"50-54",591,343,248,
"180",2004,"55-59",424,244,180,
"180",2004,"60-64",265,139,126,
"180",2004,"65-69",191,112,79,
"180",2004,"70-74",129,71,58,
"180",2004,"75-79",113,44,69,
"180",2004,"80-84",61,33,28,
"180",2004,"85+",41,14,27,
"185",2004,"0-4",723,388,335,
"185",2004,"5-9",615,334,281,
"185",2004,"10-14",756,380,376,
"185",2004,"15-19",792,415,377,
"185",2004,"20-24",533,281,252,
"185",2004,"25-29",369,190,179,
"185",2004,"30-34",436,239,197,
"185",2004,"35-39",539,303,236,
"185",2004,"40-44",521,273,248,
"185",2004,"45-49",565,301,264,
"185",2004,"50-54",420,239,181,
"185",2004,"55-59",328,187,141,
"185",2004,"60-64",202,111,91,
"185",2004,"65-69",124,66,58,
"185",2004,"70-74",70,37,33,
"185",2004,"75-79",43,16,27,
"185",2004,"80-84",44,15,29,
"185",2004,"85+",18,5,13,
"188",2004,"0-4",755,385,370,
"188",2004,"5-9",723,367,356,
"188",2004,"10-14",851,456,395,
"188",2004,"15-19",841,415,426,
"188",2004,"20-24",583,314,269,
"188",2004,"25-29",440,231,209,
"188",2004,"30-34",456,251,205,
"188",2004,"35-39",518,289,229,
"188",2004,"40-44",485,274,211,
"188",2004,"45-49",475,285,190,
"188",2004,"50-54",383,220,163,
"188",2004,"55-59",306,173,133,
"188",2004,"60-64",168,90,78,
"188",2004,"65-69",107,61,46,
"188",2004,"70-74",130,64,66,
"188",2004,"75-79",77,33,44,
"188",2004,"80-84",37,11,26,
"188",2004,"85+",25,11,14,
"195",2004,"0-4",259,139,120,
"195",2004,"5-9",309,161,148,
"195",2004,"10-14",351,178,173,
"195",2004,"15-19",371,191,180,
"195",2004,"20-24",202,115,87,
"195",2004,"25-29",162,81,81,
"195",2004,"30-34",259,138,121,
"195",2004,"35-39",320,168,152,
"195",2004,"40-44",323,159,164,
"195",2004,"45-49",422,213,209,
"195",2004,"50-54",351,195,156,
"195",2004,"55-59",285,154,131,
"195",2004,"60-64",187,106,81,
"195",2004,"65-69",113,66,47,
"195",2004,"70-74",72,38,34,
"195",2004,"75-79",84,39,45,
"195",2004,"80-84",61,28,33,
"195",2004,"85+",36,16,20,
"198",2004,"0-4",345,178,167,
"198",2004,"5-9",448,234,214,
"198",2004,"10-14",480,259,221,
"198",2004,"15-19",473,248,225,
"198",2004,"20-24",340,193,147,
"198",2004,"25-29",190,109,81,
"198",2004,"30-34",310,154,156,
"198",2004,"35-39",384,196,188,
"198",2004,"40-44",506,271,235,
"198",2004,"45-49",550,317,233,
"198",2004,"50-54",500,287,213,
"198",2004,"55-59",386,224,162,
"198",2004,"60-64",282,171,111,
"198",2004,"65-69",172,108,64,
"198",2004,"70-74",105,69,36,
"198",2004,"75-79",73,39,34,
"198",2004,"80-84",38,17,21,
"198",2004,"85+",15,4,11,
"220",2004,"0-4",616,351,265,
"220",2004,"5-9",540,279,261,
"220",2004,"10-14",693,353,340,
"220",2004,"15-19",672,319,353,
"220",2004,"20-24",579,333,246,
"220",2004,"25-29",521,262,259,
"220",2004,"30-34",579,292,287,
"220",2004,"35-39",675,342,333,
"220",2004,"40-44",701,379,322,
"220",2004,"45-49",814,399,415,
"220",2004,"50-54",729,379,350,
"220",2004,"55-59",538,278,260,
"220",2004,"60-64",351,209,142,
"220",2004,"65-69",320,152,168,
"220",2004,"70-74",202,95,107,
"220",2004,"75-79",137,63,74,
"220",2004,"80-84",102,40,62,
"220",2004,"85+",91,23,68,
"230",2004,"0-4",35,20,15,
"230",2004,"5-9",44,20,24,
"230",2004,"10-14",58,27,31,
"230",2004,"15-19",34,20,14,
"230",2004,"20-24",32,16,16,
"230",2004,"25-29",64,31,33,
"230",2004,"30-34",100,46,54,
"230",2004,"35-39",73,44,29,
"230",2004,"40-44",82,46,36,
"230",2004,"45-49",79,44,35,
"230",2004,"50-54",100,60,40,
"230",2004,"55-59",79,38,41,
"230",2004,"60-64",52,24,28,
"230",2004,"65-69",25,16,9,
"230",2004,"70-74",18,10,8,
"230",2004,"75-79",15,5,10,
"230",2004,"80-84",9,4,5,
"230",2004,"85+",8,4,4,
"240",2004,"0-4",334,157,177,
"240",2004,"5-9",440,231,209,
"240",2004,"10-14",561,277,284,
"240",2004,"15-19",621,293,328,
"240",2004,"20-24",300,174,126,
"240",2004,"25-29",192,90,102,
"240",2004,"30-34",360,180,180,
"240",2004,"35-39",369,171,198,
"240",2004,"40-44",501,269,232,
"240",2004,"45-49",563,302,261,
"240",2004,"50-54",529,285,244,
"240",2004,"55-59",387,219,168,
"240",2004,"60-64",314,190,124,
"240",2004,"65-69",204,121,83,
"240",2004,"70-74",108,53,55,
"240",2004,"75-79",91,50,41,
"240",2004,"80-84",30,12,18,
"240",2004,"85+",29,5,24,
"261",2004,"0-4",661,338,323,
"261",2004,"5-9",700,344,356,
"261",2004,"10-14",861,468,393,
"261",2004,"15-19",940,486,454,
"261",2004,"20-24",536,301,235,
"261",2004,"25-29",397,228,169,
"261",2004,"30-34",557,258,299,
"261",2004,"35-39",752,398,354,
"261",2004,"40-44",928,483,445,
"261",2004,"45-49",1081,571,510,
"261",2004,"50-54",965,549,416,
"261",2004,"55-59",716,406,310,
"261",2004,"60-64",383,234,149,
"261",2004,"65-69",234,130,104,
"261",2004,"70-74",151,75,76,
"261",2004,"75-79",131,72,59,
"261",2004,"80-84",66,26,40,
"261",2004,"85+",43,15,28,
"270",2004,"0-4",865,461,404,
"270",2004,"5-9",728,389,339,
"270",2004,"10-14",1062,572,490,
"270",2004,"15-19",958,468,490,
"270",2004,"20-24",553,295,258,
"270",2004,"25-29",345,163,182,
"270",2004,"30-34",439,212,227,
"270",2004,"35-39",447,246,201,
"270",2004,"40-44",428,229,199,
"270",2004,"45-49",409,224,185,
"270",2004,"50-54",274,150,124,
"270",2004,"55-59",247,142,105,
"270",2004,"60-64",158,81,77,
"270",2004,"65-69",129,64,65,
"270",2004,"70-74",116,51,65,
"270",2004,"75-79",64,28,36,
"270",2004,"80-84",47,24,23,
"270",2004,"85+",14,5,9,
"275",2004,"0-4",128,66,62,
"275",2004,"5-9",150,78,72,
"275",2004,"10-14",183,96,87,
"275",2004,"15-19",204,114,90,
"275",2004,"20-24",85,47,38,
"275",2004,"25-29",46,25,21,
"275",2004,"30-34",92,38,54,
"275",2004,"35-39",133,62,71,
"275",2004,"40-44",174,83,91,
"275",2004,"45-49",240,127,113,
"275",2004,"50-54",218,121,97,
"275",2004,"55-59",170,86,84,
"275",2004,"60-64",143,81,62,
"275",2004,"65-69",104,60,44,
"275",2004,"70-74",75,39,36,
"275",2004,"75-79",62,31,31,
"275",2004,"80-84",35,16,19,
"275",2004,"85+",39,16,23,
"282",2004,"0-4",32,18,14,
"282",2004,"5-9",46,24,22,
"282",2004,"10-14",79,46,33,
"282",2004,"15-19",59,33,26,
"282",2004,"20-24",32,19,13,
"282",2004,"25-29",20,15,5,
"282",2004,"30-34",45,22,23,
"282",2004,"35-39",63,35,28,
"282",2004,"40-44",73,49,24,
"282",2004,"45-49",82,59,23,
"282",2004,"50-54",71,44,27,
"282",2004,"55-59",50,28,22,
"282",2004,"60-64",27,23,4,
"282",2004,"65-69",20,8,12,
"282",2004,"70-74",14,7,7,
"282",2004,"75-79",12,7,5,
"282",2004,"80-84",4,0,4,
"282",2004,"85+",2,0,2,
"290",2004,"0-4",444,235,209,
"290",2004,"5-9",466,242,224,
"290",2004,"10-14",662,341,321,
"290",2004,"15-19",725,392,333,
"290",2004,"20-24",419,251,168,
"290",2004,"25-29",258,162,96,
"290",2004,"30-34",325,161,164,
"290",2004,"35-39",379,216,163,
"290",2004,"40-44",486,233,253,
"290",2004,"45-49",512,293,219,
"290",2004,"50-54",499,275,224,
"290",2004,"55-59",384,218,166,
"290",2004,"60-64",212,124,88,
"290",2004,"65-69",164,92,72,
"290",2004,"70-74",134,66,68,
"290",2004,"75-79",106,61,45,
"290",2004,"80-84",49,27,22,
"290",2004,"85+",37,19,18,
"000",2005,"0-4",49634,25468,24166,
"000",2005,"5-9",47799,24463,23336,
"000",2005,"10-14",55456,28377,27079,
"000",2005,"15-19",55858,28866,26992,
"000",2005,"20-24",48837,26524,22313,
"000",2005,"25-29",42392,22470,19922,
"000",2005,"30-34",46709,23815,22894,
"000",2005,"35-39",47712,24681,23031,
"000",2005,"40-44",55820,28609,27211,
"000",2005,"45-49",57582,29495,28087,
"000",2005,"50-54",52280,27449,24831,
"000",2005,"55-59",39639,21396,18243,
"000",2005,"60-64",24910,13233,11677,
"000",2005,"65-69",15071,7898,7173,
"000",2005,"70-74",10671,5201,5470,
"000",2005,"75-79",8019,3770,4249,
"000",2005,"80-84",5058,2092,2966,
"000",2005,"85+",3699,1270,2429,
"013",2005,"0-4",74,35,39,
"013",2005,"5-9",102,47,55,
"013",2005,"10-14",84,36,48,
"013",2005,"15-19",106,55,51,
"013",2005,"20-24",186,133,53,
"013",2005,"25-29",250,169,81,
"013",2005,"30-34",165,108,57,
"013",2005,"35-39",281,207,74,
"013",2005,"40-44",386,281,105,
"013",2005,"45-49",322,215,107,
"013",2005,"50-54",294,177,117,
"013",2005,"55-59",236,157,79,
"013",2005,"60-64",99,57,42,
"013",2005,"65-69",47,29,18,
"013",2005,"70-74",16,10,6,
"013",2005,"75-79",12,8,4,
"013",2005,"80-84",12,9,3,
"013",2005,"85+",5,3,2,
"016",2005,"0-4",191,90,101,
"016",2005,"5-9",260,121,139,
"016",2005,"10-14",221,124,97,
"016",2005,"15-19",256,133,123,
"016",2005,"20-24",276,167,109,
"016",2005,"25-29",447,308,139,
"016",2005,"30-34",494,344,150,
"016",2005,"35-39",750,532,218,
"016",2005,"40-44",671,452,219,
"016",2005,"45-49",619,428,191,
"016",2005,"50-54",525,342,183,
"016",2005,"55-59",407,274,133,
"016",2005,"60-64",143,90,53,
"016",2005,"65-69",100,57,43,
"016",2005,"70-74",17,5,12,
"016",2005,"75-79",17,9,8,
"016",2005,"80-84",8,4,4,
"016",2005,"85+",4,0,4,
"020",2005,"0-4",20704,10630,10074,
"020",2005,"5-9",19861,10100,9761,
"020",2005,"10-14",22181,11328,10853,
"020",2005,"15-19",21248,10980,10268,
"020",2005,"20-24",21171,11192,9979,
"020",2005,"25-29",20341,10575,9766,
"020",2005,"30-34",21280,10786,10494,
"020",2005,"35-39",20337,10291,10046,
"020",2005,"40-44",23571,11805,11766,
"020",2005,"45-49",23492,11588,11904,
"020",2005,"50-54",20728,10616,10112,
"020",2005,"55-59",15922,8308,7614,
"020",2005,"60-64",9823,5056,4767,
"020",2005,"65-69",5649,2775,2874,
"020",2005,"70-74",4073,1857,2216,
"020",2005,"75-79",3169,1386,1783,
"020",2005,"80-84",2077,803,1274,
"020",2005,"85+",1530,500,1030,
"050",2005,"0-4",1962,1005,957,
"050",2005,"5-9",1468,818,650,
"050",2005,"10-14",1970,1035,935,
"050",2005,"15-19",1770,914,856,
"050",2005,"20-24",1241,648,593,
"050",2005,"25-29",981,506,475,
"050",2005,"30-34",1050,543,507,
"050",2005,"35-39",1109,599,510,
"050",2005,"40-44",1247,678,569,
"050",2005,"45-49",1105,609,496,
"050",2005,"50-54",928,525,403,
"050",2005,"55-59",685,385,300,
"050",2005,"60-64",542,282,260,
"050",2005,"65-69",268,131,137,
"050",2005,"70-74",242,117,125,
"050",2005,"75-79",166,89,77,
"050",2005,"80-84",98,48,50,
"050",2005,"85+",83,36,47,
"060",2005,"0-4",74,38,36,
"060",2005,"5-9",87,44,43,
"060",2005,"10-14",102,45,57,
"060",2005,"15-19",111,68,43,
"060",2005,"20-24",65,30,35,
"060",2005,"25-29",35,23,12,
"060",2005,"30-34",70,38,32,
"060",2005,"35-39",80,43,37,
"060",2005,"40-44",132,71,61,
"060",2005,"45-49",149,87,62,
"060",2005,"50-54",102,51,51,
"060",2005,"55-59",85,52,33,
"060",2005,"60-64",34,22,12,
"060",2005,"65-69",34,18,16,
"060",2005,"70-74",14,7,7,
"060",2005,"75-79",11,8,3,
"060",2005,"80-84",5,2,3,
"060",2005,"85+",3,2,1,
"068",2005,"0-4",104,55,49,
"068",2005,"5-9",90,49,41,
"068",2005,"10-14",111,63,48,
"068",2005,"15-19",138,78,60,
"068",2005,"20-24",64,35,29,
"068",2005,"25-29",65,40,25,
"068",2005,"30-34",142,77,65,
"068",2005,"35-39",133,84,49,
"068",2005,"40-44",168,92,76,
"068",2005,"45-49",242,143,99,
"068",2005,"50-54",202,118,84,
"068",2005,"55-59",142,90,52,
"068",2005,"60-64",86,58,28,
"068",2005,"65-69",48,29,19,
"068",2005,"70-74",18,13,5,
"068",2005,"75-79",9,6,3,
"068",2005,"80-84",3,2,1,
"068",2005,"85+",4,2,2,
"070",2005,"0-4",428,230,198,
"070",2005,"5-9",445,236,209,
"070",2005,"10-14",501,279,222,
"070",2005,"15-19",565,274,291,
"070",2005,"20-24",287,156,131,
"070",2005,"25-29",198,98,100,
"070",2005,"30-34",243,118,125,
"070",2005,"35-39",313,165,148,
"070",2005,"40-44",391,216,175,
"070",2005,"45-49",358,173,185,
"070",2005,"50-54",353,191,162,
"070",2005,"55-59",227,112,115,
"070",2005,"60-64",170,94,76,
"070",2005,"65-69",97,50,47,
"070",2005,"70-74",79,45,34,
"070",2005,"75-79",69,36,33,
"070",2005,"80-84",30,15,15,
"070",2005,"85+",23,11,12,
"090",2005,"0-4",7536,3844,3692,
"090",2005,"5-9",6365,3195,3170,
"090",2005,"10-14",6819,3463,3356,
"090",2005,"15-19",7093,3644,3449,
"090",2005,"20-24",8151,4643,3508,
"090",2005,"25-29",8597,4755,3842,
"090",2005,"30-34",6973,3616,3357,
"090",2005,"35-39",6189,3165,3024,
"090",2005,"40-44",6818,3425,3393,
"090",2005,"45-49",6777,3352,3425,
"090",2005,"50-54",6409,3367,3042,
"090",2005,"55-59",4929,2712,2217,
"090",2005,"60-64",2954,1584,1370,
"090",2005,"65-69",1720,926,794,
"090",2005,"70-74",1191,585,606,
"090",2005,"75-79",854,418,436,
"090",2005,"80-84",585,240,345,
"090",2005,"85+",421,143,278,
"100",2005,"0-4",93,46,47,
"100",2005,"5-9",135,64,71,
"100",2005,"10-14",153,83,70,
"100",2005,"15-19",180,88,92,
"100",2005,"20-24",91,52,39,
"100",2005,"25-29",42,16,26,
"100",2005,"30-34",101,46,55,
"100",2005,"35-39",154,79,75,
"100",2005,"40-44",181,86,95,
"100",2005,"45-49",262,139,123,
"100",2005,"50-54",248,138,110,
"100",2005,"55-59",245,123,122,
"100",2005,"60-64",148,73,75,
"100",2005,"65-69",88,45,43,
"100",2005,"70-74",79,41,38,
"100",2005,"75-79",51,29,22,
"100",2005,"80-84",34,16,18,
"100",2005,"85+",27,10,17,
"105",2005,"0-4",109,62,47,
"105",2005,"5-9",121,55,66,
"105",2005,"10-14",179,102,77,
"105",2005,"15-19",195,90,105,
"105",2005,"20-24",139,82,57,
"105",2005,"25-29",62,35,27,
"105",2005,"30-34",89,50,39,
"105",2005,"35-39",119,75,44,
"105",2005,"40-44",207,102,105,
"105",2005,"45-49",208,122,86,
"105",2005,"50-54",224,112,112,
"105",2005,"55-59",216,127,89,
"105",2005,"60-64",131,80,51,
"105",2005,"65-69",106,62,44,
"105",2005,"70-74",51,39,12,
"105",2005,"75-79",33,17,16,
"105",2005,"80-84",20,12,8,
"105",2005,"85+",16,1,15,
"110",2005,"0-4",2004,1024,980,
"110",2005,"5-9",2013,1017,996,
"110",2005,"10-14",2364,1192,1172,
"110",2005,"15-19",2497,1295,1202,
"110",2005,"20-24",2033,1063,970,
"110",2005,"25-29",1694,803,891,
"110",2005,"30-34",2111,1080,1031,
"110",2005,"35-39",2423,1262,1161,
"110",2005,"40-44",2770,1365,1405,
"110",2005,"45-49",2947,1490,1457,
"110",2005,"50-54",2944,1496,1448,
"110",2005,"55-59",2260,1198,1062,
"110",2005,"60-64",1185,605,580,
"110",2005,"65-69",738,385,353,
"110",2005,"70-74",474,232,242,
"110",2005,"75-79",391,162,229,
"110",2005,"80-84",267,100,167,
"110",2005,"85+",225,77,148,
"122",2005,"0-4",3124,1565,1559,
"122",2005,"5-9",3350,1695,1655,
"122",2005,"10-14",4194,2157,2037,
"122",2005,"15-19",4597,2348,2249,
"122",2005,"20-24",3220,1833,1387,
"122",2005,"25-29",1578,875,703,
"122",2005,"30-34",2981,1525,1456,
"122",2005,"35-39",3269,1660,1609,
"122",2005,"40-44",4315,2242,2073,
"122",2005,"45-49",4987,2579,2408,
"122",2005,"50-54",5062,2644,2418,
"122",2005,"55-59",3746,2039,1707,
"122",2005,"60-64",2624,1409,1215,
"122",2005,"65-69",1668,920,748,
"122",2005,"70-74",1212,622,590,
"122",2005,"75-79",904,453,451,
"122",2005,"80-84",541,240,301,
"122",2005,"85+",363,121,242,
"130",2005,"0-4",815,420,395,
"130",2005,"5-9",914,474,440,
"130",2005,"10-14",1067,544,523,
"130",2005,"15-19",1040,532,508,
"130",2005,"20-24",814,434,380,
"130",2005,"25-29",605,315,290,
"130",2005,"30-34",798,393,405,
"130",2005,"35-39",960,478,482,
"130",2005,"40-44",1194,648,546,
"130",2005,"45-49",1247,617,630,
"130",2005,"50-54",1107,582,525,
"130",2005,"55-59",1001,527,474,
"130",2005,"60-64",614,325,289,
"130",2005,"65-69",375,220,155,
"130",2005,"70-74",251,108,143,
"130",2005,"75-79",232,110,122,
"130",2005,"80-84",154,62,92,
"130",2005,"85+",143,57,86,
"150",2005,"0-4",1077,555,522,
"150",2005,"5-9",1174,596,578,
"150",2005,"10-14",1187,602,585,
"150",2005,"15-19",1160,628,532,
"150",2005,"20-24",811,457,354,
"150",2005,"25-29",795,446,349,
"150",2005,"30-34",928,481,447,
"150",2005,"35-39",1110,596,514,
"150",2005,"40-44",1250,643,607,
"150",2005,"45-49",1106,621,485,
"150",2005,"50-54",1009,541,468,
"150",2005,"55-59",718,396,322,
"150",2005,"60-64",427,224,203,
"150",2005,"65-69",272,139,133,
"150",2005,"70-74",224,122,102,
"150",2005,"75-79",108,48,60,
"150",2005,"80-84",65,31,34,
"150",2005,"85+",70,31,39,
"164",2005,"0-4",106,54,52,
"164",2005,"5-9",140,62,78,
"164",2005,"10-14",190,103,87,
"164",2005,"15-19",185,90,95,
"164",2005,"20-24",139,78,61,
"164",2005,"25-29",53,25,28,
"164",2005,"30-34",77,41,36,
"164",2005,"35-39",91,50,41,
"164",2005,"40-44",144,85,59,
"164",2005,"45-49",162,92,70,
"164",2005,"50-54",114,60,54,
"164",2005,"55-59",70,40,30,
"164",2005,"60-64",74,38,36,
"164",2005,"65-69",39,26,13,
"164",2005,"70-74",28,14,14,
"164",2005,"75-79",17,11,6,
"164",2005,"80-84",11,6,5,
"164",2005,"85+",7,1,6,
"170",2005,"0-4",4965,2564,2401,
"170",2005,"5-9",5542,2847,2695,
"170",2005,"10-14",6832,3463,3369,
"170",2005,"15-19",7024,3672,3352,
"170",2005,"20-24",4949,2687,2262,
"170",2005,"25-29",3250,1633,1617,
"170",2005,"30-34",4690,2305,2385,
"170",2005,"35-39",5393,2706,2687,
"170",2005,"40-44",6568,3309,3259,
"170",2005,"45-49",7172,3791,3381,
"170",2005,"50-54",6230,3261,2969,
"170",2005,"55-59",4239,2309,1930,
"170",2005,"60-64",2927,1567,1360,
"170",2005,"65-69",1901,1001,900,
"170",2005,"70-74",1359,686,673,
"170",2005,"75-79",924,479,445,
"170",2005,"80-84",535,236,299,
"170",2005,"85+",371,128,243,
"180",2005,"0-4",1019,532,487,
"180",2005,"5-9",712,389,323,
"180",2005,"10-14",1065,555,510,
"180",2005,"15-19",957,494,463,
"180",2005,"20-24",706,382,324,
"180",2005,"25-29",550,307,243,
"180",2005,"30-34",641,326,315,
"180",2005,"35-39",581,338,243,
"180",2005,"40-44",702,399,303,
"180",2005,"45-49",656,357,299,
"180",2005,"50-54",602,342,260,
"180",2005,"55-59",439,269,170,
"180",2005,"60-64",288,148,140,
"180",2005,"65-69",183,108,75,
"180",2005,"70-74",130,74,56,
"180",2005,"75-79",112,44,68,
"180",2005,"80-84",64,32,32,
"180",2005,"85+",41,14,27,
"185",2005,"0-4",721,373,348,
"185",2005,"5-9",588,342,246,
"185",2005,"10-14",690,325,365,
"185",2005,"15-19",764,419,345,
"185",2005,"20-24",572,307,265,
"185",2005,"25-29",323,152,171,
"185",2005,"30-34",413,232,181,
"185",2005,"35-39",450,246,204,
"185",2005,"40-44",517,282,235,
"185",2005,"45-49",566,302,264,
"185",2005,"50-54",421,241,180,
"185",2005,"55-59",339,194,145,
"185",2005,"60-64",195,103,92,
"185",2005,"65-69",116,66,50,
"185",2005,"70-74",74,37,37,
"185",2005,"75-79",50,20,30,
"185",2005,"80-84",40,12,28,
"185",2005,"85+",18,8,10,
"188",2005,"0-4",763,397,366,
"188",2005,"5-9",712,367,345,
"188",2005,"10-14",796,406,390,
"188",2005,"15-19",855,433,422,
"188",2005,"20-24",620,328,292,
"188",2005,"25-29",417,215,202,
"188",2005,"30-34",470,257,213,
"188",2005,"35-39",483,283,200,
"188",2005,"40-44",495,272,223,
"188",2005,"45-49",466,280,186,
"188",2005,"50-54",412,236,176,
"188",2005,"55-59",299,177,122,
"188",2005,"60-64",184,96,88,
"188",2005,"65-69",114,69,45,
"188",2005,"70-74",123,56,67,
"188",2005,"75-79",86,38,48,
"188",2005,"80-84",40,12,28,
"188",2005,"85+",25,9,16,
"195",2005,"0-4",235,124,111,
"195",2005,"5-9",303,159,144,
"195",2005,"10-14",331,168,163,
"195",2005,"15-19",386,197,189,
"195",2005,"20-24",206,120,86,
"195",2005,"25-29",148,73,75,
"195",2005,"30-34",243,129,114,
"195",2005,"35-39",320,169,151,
"195",2005,"40-44",297,147,150,
"195",2005,"45-49",429,212,217,
"195",2005,"50-54",357,200,157,
"195",2005,"55-59",302,162,140,
"195",2005,"60-64",199,113,86,
"195",2005,"65-69",121,72,49,
"195",2005,"70-74",66,35,31,
"195",2005,"75-79",83,39,44,
"195",2005,"80-84",65,30,35,
"195",2005,"85+",36,18,18,
"198",2005,"0-4",323,165,158,
"198",2005,"5-9",441,229,212,
"198",2005,"10-14",465,255,210,
"198",2005,"15-19",467,242,225,
"198",2005,"20-24",358,202,156,
"198",2005,"25-29",164,98,66,
"198",2005,"30-34",301,147,154,
"198",2005,"35-39",357,181,176,
"198",2005,"40-44",492,260,232,
"198",2005,"45-49",547,315,232,
"198",2005,"50-54",519,297,222,
"198",2005,"55-59",401,232,169,
"198",2005,"60-64",298,181,117,
"198",2005,"65-69",180,112,68,
"198",2005,"70-74",105,71,34,
"198",2005,"75-79",74,40,34,
"198",2005,"80-84",41,18,23,
"198",2005,"85+",13,5,8,
"220",2005,"0-4",625,344,281,
"220",2005,"5-9",558,314,244,
"220",2005,"10-14",667,326,341,
"220",2005,"15-19",683,333,350,
"220",2005,"20-24",591,333,258,
"220",2005,"25-29",543,278,265,
"220",2005,"30-34",574,281,293,
"220",2005,"35-39",668,350,318,
"220",2005,"40-44",702,372,330,
"220",2005,"45-49",808,402,406,
"220",2005,"50-54",751,385,366,
"220",2005,"55-59",560,292,268,
"220",2005,"60-64",382,218,164,
"220",2005,"65-69",305,153,152,
"220",2005,"70-74",218,99,119,
"220",2005,"75-79",148,74,74,
"220",2005,"80-84",113,42,71,
"220",2005,"85+",94,25,69,
"230",2005,"0-4",27,12,15,
"230",2005,"5-9",35,16,19,
"230",2005,"10-14",59,27,32,
"230",2005,"15-19",30,18,12,
"230",2005,"20-24",25,13,12,
"230",2005,"25-29",57,28,29,
"230",2005,"30-34",103,45,58,
"230",2005,"35-39",69,43,26,
"230",2005,"40-44",81,46,35,
"230",2005,"45-49",73,40,33,
"230",2005,"50-54",104,65,39,
"230",2005,"55-59",83,42,41,
"230",2005,"60-64",56,25,31,
"230",2005,"65-69",26,17,9,
"230",2005,"70-74",18,11,7,
"230",2005,"75-79",15,4,11,
"230",2005,"80-84",9,3,6,
"230",2005,"85+",5,3,2,
"240",2005,"0-4",366,166,200,
"240",2005,"5-9",448,235,213,
"240",2005,"10-14",547,274,273,
"240",2005,"15-19",615,286,329,
"240",2005,"20-24",387,219,168,
"240",2005,"25-29",190,93,97,
"240",2005,"30-34",372,178,194,
"240",2005,"35-39",374,180,194,
"240",2005,"40-44",511,266,245,
"240",2005,"45-49",575,315,260,
"240",2005,"50-54",550,292,258,
"240",2005,"55-59",445,255,190,
"240",2005,"60-64",318,191,127,
"240",2005,"65-69",226,135,91,
"240",2005,"70-74",118,61,57,
"240",2005,"75-79",92,44,48,
"240",2005,"80-84",34,19,15,
"240",2005,"85+",31,6,25,
"261",2005,"0-4",667,337,330,
"261",2005,"5-9",687,334,353,
"261",2005,"10-14",816,438,378,
"261",2005,"15-19",946,503,443,
"261",2005,"20-24",584,307,277,
"261",2005,"25-29",405,258,147,
"261",2005,"30-34",553,242,311,
"261",2005,"35-39",713,382,331,
"261",2005,"40-44",905,488,417,
"261",2005,"45-49",1072,547,525,
"261",2005,"50-54",999,565,434,
"261",2005,"55-59",775,436,339,
"261",2005,"60-64",402,251,151,
"261",2005,"65-69",244,131,113,
"261",2005,"70-74",156,84,72,
"261",2005,"75-79",137,72,65,
"261",2005,"80-84",66,26,40,
"261",2005,"85+",50,18,32,
"270",2005,"0-4",966,512,454,
"270",2005,"5-9",625,338,287,
"270",2005,"10-14",1021,540,481,
"270",2005,"15-19",1005,507,498,
"270",2005,"20-24",597,312,285,
"270",2005,"25-29",319,152,167,
"270",2005,"30-34",423,214,209,
"270",2005,"35-39",460,246,214,
"270",2005,"40-44",406,215,191,
"270",2005,"45-49",427,231,196,
"270",2005,"50-54",281,152,129,
"270",2005,"55-59",260,149,111,
"270",2005,"60-64",173,88,85,
"270",2005,"65-69",119,60,59,
"270",2005,"70-74",116,53,63,
"270",2005,"75-79",64,27,37,
"270",2005,"80-84",50,27,23,
"270",2005,"85+",20,8,12,
"275",2005,"0-4",114,55,59,
"275",2005,"5-9",144,75,69,
"275",2005,"10-14",170,89,81,
"275",2005,"15-19",215,121,94,
"275",2005,"20-24",89,49,40,
"275",2005,"25-29",35,21,14,
"275",2005,"30-34",84,34,50,
"275",2005,"35-39",125,59,66,
"275",2005,"40-44",158,75,83,
"275",2005,"45-49",244,129,115,
"275",2005,"50-54",229,128,101,
"275",2005,"55-59",178,90,88,
"275",2005,"60-64",148,83,65,
"275",2005,"65-69",111,65,46,
"275",2005,"70-74",77,41,36,
"275",2005,"75-79",65,33,32,
"275",2005,"80-84",34,15,19,
"275",2005,"85+",38,14,24,
"282",2005,"0-4",33,18,15,
"282",2005,"5-9",38,20,18,
"282",2005,"10-14",77,46,31,
"282",2005,"15-19",51,24,27,
"282",2005,"20-24",42,29,13,
"282",2005,"25-29",17,12,5,
"282",2005,"30-34",36,19,17,
"282",2005,"35-39",61,36,25,
"282",2005,"40-44",71,47,24,
"282",2005,"45-49",74,51,23,
"282",2005,"50-54",74,48,26,
"282",2005,"55-59",51,29,22,
"282",2005,"60-64",29,22,7,
"282",2005,"65-69",20,10,10,
"282",2005,"70-74",14,8,6,
"282",2005,"75-79",11,5,6,
"282",2005,"80-84",8,3,5,
"282",2005,"85+",1,0,1,
"290",2005,"0-4",409,216,193,
"290",2005,"5-9",441,225,216,
"290",2005,"10-14",597,309,288,
"290",2005,"15-19",719,400,319,
"290",2005,"20-24",423,233,190,
"290",2005,"25-29",231,161,70,
"290",2005,"30-34",304,160,144,
"290",2005,"35-39",340,176,164,
"290",2005,"40-44",470,240,230,
"290",2005,"45-49",490,268,222,
"290",2005,"50-54",502,277,225,
"290",2005,"55-59",379,220,159,
"290",2005,"60-64",257,150,107,
"290",2005,"65-69",156,87,69,
"290",2005,"70-74",128,68,60,
"290",2005,"75-79",115,61,54,
"290",2005,"80-84",49,27,22,
"290",2005,"85+",32,19,13,
"000",2006,"0-4",50106,25736,24370,
"000",2006,"5-9",47865,24542,23323,
"000",2006,"10-14",53946,27602,26344,
"000",2006,"15-19",55933,28837,27096,
"000",2006,"20-24",51605,28011,23594,
"000",2006,"25-29",43222,22990,20232,
"000",2006,"30-34",45946,23529,22417,
"000",2006,"35-39",47480,24431,23049,
"000",2006,"40-44",53923,27760,26163,
"000",2006,"45-49",57621,29500,28121,
"000",2006,"50-54",53885,28120,25765,
"000",2006,"55-59",42627,23060,19567,
"000",2006,"60-64",26024,13735,12289,
"000",2006,"65-69",16140,8529,7611,
"000",2006,"70-74",10864,5331,5533,
"000",2006,"75-79",8290,3899,4391,
"000",2006,"80-84",5237,2192,3045,
"000",2006,"85+",3869,1341,2528,
"013",2006,"0-4",73,33,40,
"013",2006,"5-9",77,33,44,
"013",2006,"10-14",79,31,48,
"013",2006,"15-19",100,57,43,
"013",2006,"20-24",170,119,51,
"013",2006,"25-29",256,181,75,
"013",2006,"30-34",139,88,51,
"013",2006,"35-39",261,192,69,
"013",2006,"40-44",378,276,102,
"013",2006,"45-49",343,229,114,
"013",2006,"50-54",277,174,103,
"013",2006,"55-59",251,164,87,
"013",2006,"60-64",108,63,45,
"013",2006,"65-69",55,34,21,
"013",2006,"70-74",14,9,5,
"013",2006,"75-79",13,9,4,
"013",2006,"80-84",11,7,4,
"013",2006,"85+",8,6,2,
"016",2006,"0-4",165,74,91,
"016",2006,"5-9",210,99,111,
"016",2006,"10-14",210,117,93,
"016",2006,"15-19",216,110,106,
"016",2006,"20-24",262,157,105,
"016",2006,"25-29",401,303,98,
"016",2006,"30-34",449,307,142,
"016",2006,"35-39",638,448,190,
"016",2006,"40-44",675,471,204,
"016",2006,"45-49",617,423,194,
"016",2006,"50-54",524,346,178,
"016",2006,"55-59",417,294,123,
"016",2006,"60-64",159,92,67,
"016",2006,"65-69",107,65,42,
"016",2006,"70-74",25,14,11,
"016",2006,"75-79",15,6,9,
"016",2006,"80-84",7,3,4,
"016",2006,"85+",8,1,7,
"020",2006,"0-4",21149,10948,10201,
"020",2006,"5-9",19978,10223,9755,
"020",2006,"10-14",21897,11192,10705,
"020",2006,"15-19",21618,11154,10464,
"020",2006,"20-24",22357,11844,10513,
"020",2006,"25-29",20985,10845,10140,
"020",2006,"30-34",20865,10656,10209,
"020",2006,"35-39",20666,10477,10189,
"020",2006,"40-44",22821,11405,11416,
"020",2006,"45-49",23592,11671,11921,
"020",2006,"50-54",21477,10909,10568,
"020",2006,"55-59",16982,8901,8081,
"020",2006,"60-64",10349,5305,5044,
"020",2006,"65-69",5895,2900,2995,
"020",2006,"70-74",4197,1939,2258,
"020",2006,"75-79",3277,1424,1853,
"020",2006,"80-84",2123,840,1283,
"020",2006,"85+",1603,531,1072,
"050",2006,"0-4",1918,981,937,
"050",2006,"5-9",1502,831,671,
"050",2006,"10-14",1891,993,898,
"050",2006,"15-19",1767,902,865,
"050",2006,"20-24",1320,710,610,
"050",2006,"25-29",934,491,443,
"050",2006,"30-34",1030,523,507,
"050",2006,"35-39",1060,567,493,
"050",2006,"40-44",1219,675,544,
"050",2006,"45-49",1098,605,493,
"050",2006,"50-54",956,543,413,
"050",2006,"55-59",727,407,320,
"050",2006,"60-64",516,270,246,
"050",2006,"65-69",310,157,153,
"050",2006,"70-74",241,115,126,
"050",2006,"75-79",167,88,79,
"050",2006,"80-84",103,49,54,
"050",2006,"85+",72,29,43,
"060",2006,"0-4",54,28,26,
"060",2006,"5-9",77,41,36,
"060",2006,"10-14",88,38,50,
"060",2006,"15-19",104,61,43,
"060",2006,"20-24",56,27,29,
"060",2006,"25-29",30,20,10,
"060",2006,"30-34",52,29,23,
"060",2006,"35-39",62,34,28,
"060",2006,"40-44",110,57,53,
"060",2006,"45-49",155,92,63,
"060",2006,"50-54",95,47,48,
"060",2006,"55-59",93,59,34,
"060",2006,"60-64",33,21,12,
"060",2006,"65-69",31,18,13,
"060",2006,"70-74",17,10,7,
"060",2006,"75-79",12,8,4,
"060",2006,"80-84",6,2,4,
"060",2006,"85+",2,1,1,
"068",2006,"0-4",95,54,41,
"068",2006,"5-9",87,53,34,
"068",2006,"10-14",110,53,57,
"068",2006,"15-19",134,77,57,
"068",2006,"20-24",56,30,26,
"068",2006,"25-29",57,40,17,
"068",2006,"30-34",138,73,65,
"068",2006,"35-39",131,79,52,
"068",2006,"40-44",154,87,67,
"068",2006,"45-49",231,133,98,
"068",2006,"50-54",210,126,84,
"068",2006,"55-59",153,94,59,
"068",2006,"60-64",77,55,22,
"068",2006,"65-69",62,39,23,
"068",2006,"70-74",17,11,6,
"068",2006,"75-79",11,7,4,
"068",2006,"80-84",4,3,1,
"068",2006,"85+",5,3,2,
"070",2006,"0-4",415,219,196,
"070",2006,"5-9",418,221,197,
"070",2006,"10-14",509,287,222,
"070",2006,"15-19",559,266,293,
"070",2006,"20-24",316,167,149,
"070",2006,"25-29",207,107,100,
"070",2006,"30-34",259,133,126,
"070",2006,"35-39",266,144,122,
"070",2006,"40-44",392,205,187,
"070",2006,"45-49",347,175,172,
"070",2006,"50-54",378,202,176,
"070",2006,"55-59",245,119,126,
"070",2006,"60-64",172,101,71,
"070",2006,"65-69",106,53,53,
"070",2006,"70-74",73,44,29,
"070",2006,"75-79",72,37,35,
"070",2006,"80-84",32,15,17,
"070",2006,"85+",21,10,11,
"090",2006,"0-4",7431,3805,3626,
"090",2006,"5-9",6418,3218,3200,
"090",2006,"10-14",6497,3299,3198,
"090",2006,"15-19",7062,3608,3454,
"090",2006,"20-24",8402,4773,3629,
"090",2006,"25-29",8751,4874,3877,
"090",2006,"30-34",6912,3623,3289,
"090",2006,"35-39",6130,3100,3030,
"090",2006,"40-44",6598,3350,3248,
"090",2006,"45-49",6716,3322,3394,
"090",2006,"50-54",6548,3367,3181,
"090",2006,"55-59",5342,2965,2377,
"090",2006,"60-64",3120,1668,1452,
"090",2006,"65-69",1910,1002,908,
"090",2006,"70-74",1180,605,575,
"090",2006,"75-79",897,447,450,
"090",2006,"80-84",600,245,355,
"090",2006,"85+",439,150,289,
"100",2006,"0-4",87,36,51,
"100",2006,"5-9",133,62,71,
"100",2006,"10-14",142,81,61,
"100",2006,"15-19",177,84,93,
"100",2006,"20-24",111,64,47,
"100",2006,"25-29",59,31,28,
"100",2006,"30-34",95,41,54,
"100",2006,"35-39",155,79,76,
"100",2006,"40-44",170,77,93,
"100",2006,"45-49",250,140,110,
"100",2006,"50-54",258,142,116,
"100",2006,"55-59",273,138,135,
"100",2006,"60-64",162,79,83,
"100",2006,"65-69",89,49,40,
"100",2006,"70-74",76,38,38,
"100",2006,"75-79",56,28,28,
"100",2006,"80-84",38,20,18,
"100",2006,"85+",26,9,17,
"105",2006,"0-4",108,59,49,
"105",2006,"5-9",114,50,64,
"105",2006,"10-14",162,90,72,
"105",2006,"15-19",182,87,95,
"105",2006,"20-24",127,75,52,
"105",2006,"25-29",71,41,30,
"105",2006,"30-34",90,49,41,
"105",2006,"35-39",112,68,44,
"105",2006,"40-44",188,96,92,
"105",2006,"45-49",201,116,85,
"105",2006,"50-54",220,112,108,
"105",2006,"55-59",220,127,93,
"105",2006,"60-64",143,87,56,
"105",2006,"65-69",110,65,45,
"105",2006,"70-74",57,41,16,
"105",2006,"75-79",36,21,15,
"105",2006,"80-84",20,12,8,
"105",2006,"85+",16,3,13,
"110",2006,"0-4",1920,977,943,
"110",2006,"5-9",1968,1000,968,
"110",2006,"10-14",2247,1137,1110,
"110",2006,"15-19",2418,1235,1183,
"110",2006,"20-24",2154,1145,1009,
"110",2006,"25-29",1573,757,816,
"110",2006,"30-34",2048,1025,1023,
"110",2006,"35-39",2297,1219,1078,
"110",2006,"40-44",2639,1305,1334,
"110",2006,"45-49",2905,1477,1428,
"110",2006,"50-54",2942,1473,1469,
"110",2006,"55-59",2422,1276,1146,
"110",2006,"60-64",1268,649,619,
"110",2006,"65-69",764,407,357,
"110",2006,"70-74",475,219,256,
"110",2006,"75-79",395,173,222,
"110",2006,"80-84",262,98,164,
"110",2006,"85+",246,85,161,
"122",2006,"0-4",3092,1528,1564,
"122",2006,"5-9",3314,1671,1643,
"122",2006,"10-14",4027,2070,1957,
"122",2006,"15-19",4461,2268,2193,
"122",2006,"20-24",3501,1973,1528,
"122",2006,"25-29",1508,862,646,
"122",2006,"30-34",2897,1501,1396,
"122",2006,"35-39",3260,1653,1607,
"122",2006,"40-44",4019,2094,1925,
"122",2006,"45-49",5013,2582,2431,
"122",2006,"50-54",5210,2701,2509,
"122",2006,"55-59",4022,2195,1827,
"122",2006,"60-64",2745,1458,1287,
"122",2006,"65-69",1823,1020,803,
"122",2006,"70-74",1250,644,606,
"122",2006,"75-79",910,456,454,
"122",2006,"80-84",573,261,312,
"122",2006,"85+",400,141,259,
"130",2006,"0-4",828,412,416,
"130",2006,"5-9",903,464,439,
"130",2006,"10-14",1019,529,490,
"130",2006,"15-19",1057,538,519,
"130",2006,"20-24",853,448,405,
"130",2006,"25-29",636,347,289,
"130",2006,"30-34",773,383,390,
"130",2006,"35-39",964,470,494,
"130",2006,"40-44",1110,603,507,
"130",2006,"45-49",1274,635,639,
"130",2006,"50-54",1151,601,550,
"130",2006,"55-59",1052,562,490,
"130",2006,"60-64",630,326,304,
"130",2006,"65-69",405,236,169,
"130",2006,"70-74",252,105,147,
"130",2006,"75-79",237,113,124,
"130",2006,"80-84",158,71,87,
"130",2006,"85+",137,51,86,
"150",2006,"0-4",1037,525,512,
"150",2006,"5-9",1140,588,552,
"150",2006,"10-14",1081,549,532,
"150",2006,"15-19",1190,644,546,
"150",2006,"20-24",832,472,360,
"150",2006,"25-29",784,440,344,
"150",2006,"30-34",886,467,419,
"150",2006,"35-39",1025,541,484,
"150",2006,"40-44",1142,576,566,
"150",2006,"45-49",1104,620,484,
"150",2006,"50-54",1043,579,464,
"150",2006,"55-59",764,403,361,
"150",2006,"60-64",435,229,206,
"150",2006,"65-69",285,157,128,
"150",2006,"70-74",227,120,107,
"150",2006,"75-79",113,52,61,
"150",2006,"80-84",63,28,35,
"150",2006,"85+",69,32,37,
"164",2006,"0-4",111,56,55,
"164",2006,"5-9",118,51,67,
"164",2006,"10-14",184,101,83,
"164",2006,"15-19",181,88,93,
"164",2006,"20-24",128,68,60,
"164",2006,"25-29",61,35,26,
"164",2006,"30-34",75,38,37,
"164",2006,"35-39",68,39,29,
"164",2006,"40-44",133,78,55,
"164",2006,"45-49",166,93,73,
"164",2006,"50-54",120,66,54,
"164",2006,"55-59",70,44,26,
"164",2006,"60-64",69,32,37,
"164",2006,"65-69",39,24,15,
"164",2006,"70-74",29,14,15,
"164",2006,"75-79",16,11,5,
"164",2006,"80-84",12,8,4,
"164",2006,"85+",9,1,8,
"170",2006,"0-4",5451,2828,2623,
"170",2006,"5-9",5690,2917,2773,
"170",2006,"10-14",6907,3505,3402,
"170",2006,"15-19",7127,3732,3395,
"170",2006,"20-24",5503,2971,2532,
"170",2006,"25-29",3496,1739,1757,
"170",2006,"30-34",4772,2348,2424,
"170",2006,"35-39",5618,2806,2812,
"170",2006,"40-44",6491,3311,3180,
"170",2006,"45-49",7342,3838,3504,
"170",2006,"50-54",6554,3456,3098,
"170",2006,"55-59",4777,2572,2205,
"170",2006,"60-64",3062,1617,1445,
"170",2006,"65-69",2089,1122,967,
"170",2006,"70-74",1363,690,673,
"170",2006,"75-79",1015,522,493,
"170",2006,"80-84",576,247,329,
"170",2006,"85+",396,140,256,
"180",2006,"0-4",1008,524,484,
"180",2006,"5-9",761,410,351,
"180",2006,"10-14",994,523,471,
"180",2006,"15-19",985,499,486,
"180",2006,"20-24",752,412,340,
"180",2006,"25-29",552,316,236,
"180",2006,"30-34",664,330,334,
"180",2006,"35-39",536,306,230,
"180",2006,"40-44",699,407,292,
"180",2006,"45-49",671,362,309,
"180",2006,"50-54",587,335,252,
"180",2006,"55-59",488,298,190,
"180",2006,"60-64",284,141,143,
"180",2006,"65-69",188,110,78,
"180",2006,"70-74",139,84,55,
"180",2006,"75-79",108,40,68,
"180",2006,"80-84",69,34,35,
"180",2006,"85+",36,16,20,
"185",2006,"0-4",733,378,355,
"185",2006,"5-9",561,330,231,
"185",2006,"10-14",616,286,330,
"185",2006,"15-19",759,408,351,
"185",2006,"20-24",617,334,283,
"185",2006,"25-29",320,158,162,
"185",2006,"30-34",391,221,170,
"185",2006,"35-39",408,220,188,
"185",2006,"40-44",521,287,234,
"185",2006,"45-49",528,279,249,
"185",2006,"50-54",444,250,194,
"185",2006,"55-59",366,214,152,
"185",2006,"60-64",195,105,90,
"185",2006,"65-69",123,72,51,
"185",2006,"70-74",74,36,38,
"185",2006,"75-79",48,18,30,
"185",2006,"80-84",36,13,23,
"185",2006,"85+",22,8,14,
"188",2006,"0-4",784,405,379,
"188",2006,"5-9",689,347,342,
"188",2006,"10-14",762,385,377,
"188",2006,"15-19",867,446,421,
"188",2006,"20-24",645,353,292,
"188",2006,"25-29",413,208,205,
"188",2006,"30-34",451,245,206,
"188",2006,"35-39",443,259,184,
"188",2006,"40-44",520,288,232,
"188",2006,"45-49",470,279,191,
"188",2006,"50-54",427,251,176,
"188",2006,"55-59",317,191,126,
"188",2006,"60-64",193,95,98,
"188",2006,"65-69",116,71,45,
"188",2006,"70-74",108,51,57,
"188",2006,"75-79",95,37,58,
"188",2006,"80-84",46,16,30,
"188",2006,"85+",26,10,16,
"195",2006,"0-4",208,101,107,
"195",2006,"5-9",300,156,144,
"195",2006,"10-14",323,168,155,
"195",2006,"15-19",359,183,176,
"195",2006,"20-24",205,118,87,
"195",2006,"25-29",159,79,80,
"195",2006,"30-34",235,126,109,
"195",2006,"35-39",299,158,141,
"195",2006,"40-44",292,146,146,
"195",2006,"45-49",407,204,203,
"195",2006,"50-54",357,196,161,
"195",2006,"55-59",311,168,143,
"195",2006,"60-64",217,122,95,
"195",2006,"65-69",135,82,53,
"195",2006,"70-74",72,39,33,
"195",2006,"75-79",80,37,43,
"195",2006,"80-84",62,29,33,
"195",2006,"85+",35,17,18,
"198",2006,"0-4",325,168,157,
"198",2006,"5-9",439,227,212,
"198",2006,"10-14",453,248,205,
"198",2006,"15-19",442,233,209,
"198",2006,"20-24",344,191,153,
"198",2006,"25-29",187,109,78,
"198",2006,"30-34",298,148,150,
"198",2006,"35-39",351,177,174,
"198",2006,"40-44",465,247,218,
"198",2006,"45-49",532,304,228,
"198",2006,"50-54",514,290,224,
"198",2006,"55-59",425,245,180,
"198",2006,"60-64",312,190,122,
"198",2006,"65-69",198,121,77,
"198",2006,"70-74",112,74,38,
"198",2006,"75-79",79,44,35,
"198",2006,"80-84",41,18,23,
"198",2006,"85+",18,7,11,
"220",2006,"0-4",609,327,282,
"220",2006,"5-9",564,314,250,
"220",2006,"10-14",637,313,324,
"220",2006,"15-19",690,350,340,
"220",2006,"20-24",595,306,289,
"220",2006,"25-29",528,290,238,
"220",2006,"30-34",600,290,310,
"220",2006,"35-39",671,349,322,
"220",2006,"40-44",693,377,316,
"220",2006,"45-49",775,378,397,
"220",2006,"50-54",768,392,376,
"220",2006,"55-59",619,330,289,
"220",2006,"60-64",390,219,171,
"220",2006,"65-69",322,165,157,
"220",2006,"70-74",216,91,125,
"220",2006,"75-79",146,75,71,
"220",2006,"80-84",122,42,80,
"220",2006,"85+",98,27,71,
"230",2006,"0-4",32,17,15,
"230",2006,"5-9",34,16,18,
"230",2006,"10-14",55,25,30,
"230",2006,"15-19",34,19,15,
"230",2006,"20-24",29,14,15,
"230",2006,"25-29",63,30,33,
"230",2006,"30-34",105,46,59,
"230",2006,"35-39",70,44,26,
"230",2006,"40-44",83,47,36,
"230",2006,"45-49",72,39,33,
"230",2006,"50-54",102,61,41,
"230",2006,"55-59",88,46,42,
"230",2006,"60-64",60,29,31,
"230",2006,"65-69",30,17,13,
"230",2006,"70-74",19,12,7,
"230",2006,"75-79",14,4,10,
"230",2006,"80-84",10,4,6,
"230",2006,"85+",5,2,3,
"240",2006,"0-4",384,170,214,
"240",2006,"5-9",446,233,213,
"240",2006,"10-14",551,281,270,
"240",2006,"15-19",611,275,336,
"240",2006,"20-24",426,236,190,
"240",2006,"25-29",221,104,117,
"240",2006,"30-34",378,185,193,
"240",2006,"35-39",395,182,213,
"240",2006,"40-44",493,265,228,
"240",2006,"45-49",587,326,261,
"240",2006,"50-54",596,311,285,
"240",2006,"55-59",478,275,203,
"240",2006,"60-64",292,179,113,
"240",2006,"65-69",251,153,98,
"240",2006,"70-74",128,65,63,
"240",2006,"75-79",96,45,51,
"240",2006,"80-84",43,24,19,
"240",2006,"85+",33,7,26,
"261",2006,"0-4",620,309,311,
"261",2006,"5-9",681,336,345,
"261",2006,"10-14",758,396,362,
"261",2006,"15-19",885,466,419,
"261",2006,"20-24",640,349,291,
"261",2006,"25-29",372,242,130,
"261",2006,"30-34",519,233,286,
"261",2006,"35-39",682,354,328,
"261",2006,"40-44",849,454,395,
"261",2006,"45-49",1026,533,493,
"261",2006,"50-54",1022,565,457,
"261",2006,"55-59",795,455,340,
"261",2006,"60-64",435,271,164,
"261",2006,"65-69",262,144,118,
"261",2006,"70-74",162,82,80,
"261",2006,"75-79",125,71,54,
"261",2006,"80-84",74,29,45,
"261",2006,"85+",44,15,29,
"270",2006,"0-4",944,499,445,
"270",2006,"5-9",649,349,300,
"270",2006,"10-14",971,508,463,
"270",2006,"15-19",1008,521,487,
"270",2006,"20-24",650,338,312,
"270",2006,"25-29",313,154,159,
"270",2006,"30-34",424,213,211,
"270",2006,"35-39",430,226,204,
"270",2006,"40-44",407,225,182,
"270",2006,"45-49",434,231,203,
"270",2006,"50-54",294,162,132,
"270",2006,"55-59",269,148,121,
"270",2006,"60-64",178,91,87,
"270",2006,"65-69",114,61,53,
"270",2006,"70-74",126,56,70,
"270",2006,"75-79",68,30,38,
"270",2006,"80-84",49,26,23,
"270",2006,"85+",24,7,17,
"275",2006,"0-4",100,47,53,
"275",2006,"5-9",144,73,71,
"275",2006,"10-14",165,86,79,
"275",2006,"15-19",201,113,88,
"275",2006,"20-24",89,50,39,
"275",2006,"25-29",45,26,19,
"275",2006,"30-34",79,31,48,
"275",2006,"35-39",118,56,62,
"275",2006,"40-44",148,69,79,
"275",2006,"45-49",231,123,108,
"275",2006,"50-54",231,128,103,
"275",2006,"55-59",190,96,94,
"275",2006,"60-64",158,88,70,
"275",2006,"65-69",114,65,49,
"275",2006,"70-74",83,45,38,
"275",2006,"75-79",65,33,32,
"275",2006,"80-84",35,16,19,
"275",2006,"85+",36,15,21,
"282",2006,"0-4",37,23,14,
"282",2006,"5-9",41,22,19,
"282",2006,"10-14",68,39,29,
"282",2006,"15-19",54,25,29,
"282",2006,"20-24",46,32,14,
"282",2006,"25-29",18,12,6,
"282",2006,"30-34",35,19,16,
"282",2006,"35-39",60,35,25,
"282",2006,"40-44",69,45,24,
"282",2006,"45-49",76,55,21,
"282",2006,"50-54",72,45,27,
"282",2006,"55-59",49,29,20,
"282",2006,"60-64",30,20,10,
"282",2006,"65-69",22,13,9,
"282",2006,"70-74",14,7,7,
"282",2006,"75-79",12,6,6,
"282",2006,"80-84",8,2,6,
"282",2006,"85+",1,0,1,
"290",2006,"0-4",388,205,183,
"290",2006,"5-9",409,207,202,
"290",2006,"10-14",543,272,271,
"290",2006,"15-19",685,388,297,
"290",2006,"20-24",419,235,184,
"290",2006,"25-29",222,149,73,
"290",2006,"30-34",287,158,129,
"290",2006,"35-39",304,149,155,
"290",2006,"40-44",445,237,208,
"290",2006,"45-49",458,236,222,
"290",2006,"50-54",508,290,218,
"290",2006,"55-59",422,245,177,
"290",2006,"60-64",232,133,99,
"290",2006,"65-69",185,107,78,
"290",2006,"70-74",118,71,47,
"290",2006,"75-79",112,57,55,
"290",2006,"80-84",54,30,24,
"290",2006,"85+",34,17,17,
"000",2007,"0-4",50888,26161,24727,
"000",2007,"5-9",48023,24545,23478,
"000",2007,"10-14",52379,26838,25541,
"000",2007,"15-19",55635,28722,26913,
"000",2007,"20-24",53080,28696,24384,
"000",2007,"25-29",44686,23901,20785,
"000",2007,"30-34",45599,23356,22243,
"000",2007,"35-39",46900,24112,22788,
"000",2007,"40-44",51570,26666,24904,
"000",2007,"45-49",57003,29203,27800,
"000",2007,"50-54",55072,28628,26444,
"000",2007,"55-59",44168,23716,20452,
"000",2007,"60-64",28645,15158,13487,
"000",2007,"65-69",17358,9178,8180,
"000",2007,"70-74",11329,5573,5756,
"000",2007,"75-79",8371,3948,4423,
"000",2007,"80-84",5385,2266,3119,
"000",2007,"85+",4078,1423,2655,
"013",2007,"0-4",96,46,50,
"013",2007,"5-9",82,31,51,
"013",2007,"10-14",92,38,54,
"013",2007,"15-19",107,57,50,
"013",2007,"20-24",199,136,63,
"013",2007,"25-29",273,189,84,
"013",2007,"30-34",167,101,66,
"013",2007,"35-39",253,191,62,
"013",2007,"40-44",375,264,111,
"013",2007,"45-49",371,243,128,
"013",2007,"50-54",320,212,108,
"013",2007,"55-59",246,158,88,
"013",2007,"60-64",131,77,54,
"013",2007,"65-69",54,31,23,
"013",2007,"70-74",16,8,8,
"013",2007,"75-79",15,10,5,
"013",2007,"80-84",15,11,4,
"013",2007,"85+",6,4,2,
"016",2007,"0-4",126,54,72,
"016",2007,"5-9",166,70,96,
"016",2007,"10-14",178,96,82,
"016",2007,"15-19",197,110,87,
"016",2007,"20-24",218,134,84,
"016",2007,"25-29",351,277,74,
"016",2007,"30-34",395,274,121,
"016",2007,"35-39",539,384,155,
"016",2007,"40-44",626,447,179,
"016",2007,"45-49",624,421,203,
"016",2007,"50-54",534,385,149,
"016",2007,"55-59",414,284,130,
"016",2007,"60-64",176,102,74,
"016",2007,"65-69",95,64,31,
"016",2007,"70-74",38,17,21,
"016",2007,"75-79",15,7,8,
"016",2007,"80-84",12,3,9,
"016",2007,"85+",7,1,6,
"020",2007,"0-4",21172,10963,10209,
"020",2007,"5-9",19820,10132,9688,
"020",2007,"10-14",20946,10707,10239,
"020",2007,"15-19",21614,11158,10456,
"020",2007,"20-24",22771,12081,10690,
"020",2007,"25-29",21196,11048,10148,
"020",2007,"30-34",20239,10332,9907,
"020",2007,"35-39",20238,10214,10024,
"020",2007,"40-44",21556,10848,10708,
"020",2007,"45-49",23214,11504,11710,
"020",2007,"50-54",21921,11074,10847,
"020",2007,"55-59",17261,8958,8303,
"020",2007,"60-64",11388,5903,5485,
"020",2007,"65-69",6376,3130,3246,
"020",2007,"70-74",4284,1992,2292,
"020",2007,"75-79",3312,1445,1867,
"020",2007,"80-84",2163,864,1299,
"020",2007,"85+",1680,553,1127,
"050",2007,"0-4",1835,938,897,
"050",2007,"5-9",1530,837,693,
"050",2007,"10-14",1803,969,834,
"050",2007,"15-19",1752,855,897,
"050",2007,"20-24",1317,729,588,
"050",2007,"25-29",926,484,442,
"050",2007,"30-34",995,511,484,
"050",2007,"35-39",964,505,459,
"050",2007,"40-44",1163,662,501,
"050",2007,"45-49",1109,622,487,
"050",2007,"50-54",936,529,407,
"050",2007,"55-59",778,428,350,
"050",2007,"60-64",498,256,242,
"050",2007,"65-69",345,180,165,
"050",2007,"70-74",245,124,121,
"050",2007,"75-79",174,85,89,
"050",2007,"80-84",95,47,48,
"050",2007,"85+",77,31,46,
"060",2007,"0-4",51,26,25,
"060",2007,"5-9",71,37,34,
"060",2007,"10-14",86,37,49,
"060",2007,"15-19",96,57,39,
"060",2007,"20-24",57,33,24,
"060",2007,"25-29",31,16,15,
"060",2007,"30-34",52,32,20,
"060",2007,"35-39",61,31,30,
"060",2007,"40-44",94,51,43,
"060",2007,"45-49",152,88,64,
"060",2007,"50-54",99,47,52,
"060",2007,"55-59",90,58,32,
"060",2007,"60-64",43,27,16,
"060",2007,"65-69",32,19,13,
"060",2007,"70-74",14,6,8,
"060",2007,"75-79",16,11,5,
"060",2007,"80-84",7,3,4,
"060",2007,"85+",1,0,1,
"068",2007,"0-4",95,56,39,
"068",2007,"5-9",87,55,32,
"068",2007,"10-14",102,47,55,
"068",2007,"15-19",122,72,50,
"068",2007,"20-24",57,32,25,
"068",2007,"25-29",46,31,15,
"068",2007,"30-34",129,70,59,
"068",2007,"35-39",136,76,60,
"068",2007,"40-44",139,77,62,
"068",2007,"45-49",215,132,83,
"068",2007,"50-54",200,119,81,
"068",2007,"55-59",173,102,71,
"068",2007,"60-64",86,60,26,
"068",2007,"65-69",60,40,20,
"068",2007,"70-74",27,17,10,
"068",2007,"75-79",8,5,3,
"068",2007,"80-84",5,4,1,
"068",2007,"85+",5,3,2,
"070",2007,"0-4",417,222,195,
"070",2007,"5-9",393,214,179,
"070",2007,"10-14",496,265,231,
"070",2007,"15-19",551,269,282,
"070",2007,"20-24",347,176,171,
"070",2007,"25-29",206,110,96,
"070",2007,"30-34",248,126,122,
"070",2007,"35-39",250,137,113,
"070",2007,"40-44",357,182,175,
"070",2007,"45-49",357,184,173,
"070",2007,"50-54",387,207,180,
"070",2007,"55-59",272,135,137,
"070",2007,"60-64",174,101,73,
"070",2007,"65-69",97,50,47,
"070",2007,"70-74",88,52,36,
"070",2007,"75-79",64,33,31,
"070",2007,"80-84",33,16,17,
"070",2007,"85+",21,10,11,
"090",2007,"0-4",7770,3973,3797,
"090",2007,"5-9",6766,3369,3397,
"090",2007,"10-14",6595,3378,3217,
"090",2007,"15-19",7266,3703,3563,
"090",2007,"20-24",9216,5206,4010,
"090",2007,"25-29",9082,5055,4027,
"090",2007,"30-34",7300,3767,3533,
"090",2007,"35-39",6440,3287,3153,
"090",2007,"40-44",6598,3371,3227,
"090",2007,"45-49",6895,3417,3478,
"090",2007,"50-54",6839,3477,3362,
"090",2007,"55-59",5631,3086,2545,
"090",2007,"60-64",3585,1926,1659,
"090",2007,"65-69",2072,1098,974,
"090",2007,"70-74",1263,637,626,
"090",2007,"75-79",958,483,475,
"090",2007,"80-84",604,244,360,
"090",2007,"85+",474,166,308,
"100",2007,"0-4",103,49,54,
"100",2007,"5-9",135,61,74,
"100",2007,"10-14",139,79,60,
"100",2007,"15-19",161,83,78,
"100",2007,"20-24",119,60,59,
"100",2007,"25-29",57,24,33,
"100",2007,"30-34",98,45,53,
"100",2007,"35-39",155,77,78,
"100",2007,"40-44",165,83,82,
"100",2007,"45-49",236,126,110,
"100",2007,"50-54",263,144,119,
"100",2007,"55-59",282,143,139,
"100",2007,"60-64",182,87,95,
"100",2007,"65-69",98,54,44,
"100",2007,"70-74",73,37,36,
"100",2007,"75-79",56,26,30,
"100",2007,"80-84",42,24,18,
"100",2007,"85+",23,8,15,
"105",2007,"0-4",114,59,55,
"105",2007,"5-9",113,48,65,
"105",2007,"10-14",151,81,70,
"105",2007,"15-19",172,87,85,
"105",2007,"20-24",121,71,50,
"105",2007,"25-29",85,50,35,
"105",2007,"30-34",99,53,46,
"105",2007,"35-39",112,65,47,
"105",2007,"40-44",174,93,81,
"105",2007,"45-49",198,112,86,
"105",2007,"50-54",219,114,105,
"105",2007,"55-59",224,127,97,
"105",2007,"60-64",157,96,61,
"105",2007,"65-69",115,68,47,
"105",2007,"70-74",64,44,20,
"105",2007,"75-79",39,25,14,
"105",2007,"80-84",19,11,8,
"105",2007,"85+",18,4,14,
"110",2007,"0-4",1857,944,913,
"110",2007,"5-9",1920,978,942,
"110",2007,"10-14",2122,1087,1035,
"110",2007,"15-19",2327,1185,1142,
"110",2007,"20-24",2049,1077,972,
"110",2007,"25-29",1613,784,829,
"110",2007,"30-34",1966,989,977,
"110",2007,"35-39",2196,1163,1033,
"110",2007,"40-44",2442,1215,1227,
"110",2007,"45-49",2827,1426,1401,
"110",2007,"50-54",2933,1479,1454,
"110",2007,"55-59",2483,1305,1178,
"110",2007,"60-64",1378,712,666,
"110",2007,"65-69",820,430,390,
"110",2007,"70-74",512,241,271,
"110",2007,"75-79",381,165,216,
"110",2007,"80-84",271,103,168,
"110",2007,"85+",253,89,164,
"122",2007,"0-4",3171,1562,1609,
"122",2007,"5-9",3327,1666,1661,
"122",2007,"10-14",3882,1976,1906,
"122",2007,"15-19",4439,2277,2162,
"122",2007,"20-24",3538,1998,1540,
"122",2007,"25-29",1822,1049,773,
"122",2007,"30-34",2887,1483,1404,
"122",2007,"35-39",3314,1696,1618,
"122",2007,"40-44",3815,1990,1825,
"122",2007,"45-49",4897,2521,2376,
"122",2007,"50-54",5293,2707,2586,
"122",2007,"55-59",4253,2302,1951,
"122",2007,"60-64",3011,1625,1386,
"122",2007,"65-69",1993,1099,894,
"122",2007,"70-74",1297,667,630,
"122",2007,"75-79",937,479,458,
"122",2007,"80-84",593,270,323,
"122",2007,"85+",435,160,275,
"130",2007,"0-4",839,420,419,
"130",2007,"5-9",878,452,426,
"130",2007,"10-14",951,490,461,
"130",2007,"15-19",1041,536,505,
"130",2007,"20-24",854,444,410,
"130",2007,"25-29",690,385,305,
"130",2007,"30-34",754,383,371,
"130",2007,"35-39",934,459,475,
"130",2007,"40-44",1049,559,490,
"130",2007,"45-49",1236,624,612,
"130",2007,"50-54",1164,611,553,
"130",2007,"55-59",1070,568,502,
"130",2007,"60-64",678,340,338,
"130",2007,"65-69",430,242,188,
"130",2007,"70-74",254,114,140,
"130",2007,"75-79",229,106,123,
"130",2007,"80-84",155,72,83,
"130",2007,"85+",144,50,94,
"150",2007,"0-4",1074,547,527,
"150",2007,"5-9",1083,558,525,
"150",2007,"10-14",1114,579,535,
"150",2007,"15-19",1177,625,552,
"150",2007,"20-24",886,504,382,
"150",2007,"25-29",807,454,353,
"150",2007,"30-34",906,471,435,
"150",2007,"35-39",1011,541,470,
"150",2007,"40-44",1085,537,548,
"150",2007,"45-49",1117,640,477,
"150",2007,"50-54",1063,569,494,
"150",2007,"55-59",780,423,357,
"150",2007,"60-64",517,273,244,
"150",2007,"65-69",311,167,144,
"150",2007,"70-74",221,113,108,
"150",2007,"75-79",111,52,59,
"150",2007,"80-84",70,30,40,
"150",2007,"85+",66,29,37,
"164",2007,"0-4",116,59,57,
"164",2007,"5-9",119,55,64,
"164",2007,"10-14",165,90,75,
"164",2007,"15-19",165,74,91,
"164",2007,"20-24",140,76,64,
"164",2007,"25-29",67,40,27,
"164",2007,"30-34",77,38,39,
"164",2007,"35-39",59,36,23,
"164",2007,"40-44",122,72,50,
"164",2007,"45-49",167,96,71,
"164",2007,"50-54",110,61,49,
"164",2007,"55-59",89,50,39,
"164",2007,"60-64",59,27,32,
"164",2007,"65-69",43,24,19,
"164",2007,"70-74",31,18,13,
"164",2007,"75-79",19,11,8,
"164",2007,"80-84",13,8,5,
"164",2007,"85+",7,1,6,
"170",2007,"0-4",5907,3066,2841,
"170",2007,"5-9",5880,2998,2882,
"170",2007,"10-14",6990,3586,3404,
"170",2007,"15-19",7194,3765,3429,
"170",2007,"20-24",5610,2977,2633,
"170",2007,"25-29",3906,1952,1954,
"170",2007,"30-34",4916,2437,2479,
"170",2007,"35-39",5711,2857,2854,
"170",2007,"40-44",6394,3284,3110,
"170",2007,"45-49",7345,3793,3552,
"170",2007,"50-54",6819,3605,3214,
"170",2007,"55-59",5182,2787,2395,
"170",2007,"60-64",3353,1735,1618,
"170",2007,"65-69",2273,1250,1023,
"170",2007,"70-74",1441,718,723,
"170",2007,"75-79",1044,537,507,
"170",2007,"80-84",617,261,356,
"170",2007,"85+",430,156,274,
"180",2007,"0-4",994,523,471,
"180",2007,"5-9",784,419,365,
"180",2007,"10-14",928,493,435,
"180",2007,"15-19",998,504,494,
"180",2007,"20-24",771,409,362,
"180",2007,"25-29",550,323,227,
"180",2007,"30-34",643,337,306,
"180",2007,"35-39",529,293,236,
"180",2007,"40-44",680,393,287,
"180",2007,"45-49",650,350,300,
"180",2007,"50-54",591,335,256,
"180",2007,"55-59",491,290,201,
"180",2007,"60-64",304,161,143,
"180",2007,"65-69",208,122,86,
"180",2007,"70-74",138,83,55,
"180",2007,"75-79",99,37,62,
"180",2007,"80-84",70,33,37,
"180",2007,"85+",30,15,15,
"185",2007,"0-4",716,371,345,
"185",2007,"5-9",583,335,248,
"185",2007,"10-14",562,266,296,
"185",2007,"15-19",741,407,334,
"185",2007,"20-24",616,323,293,
"185",2007,"25-29",350,168,182,
"185",2007,"30-34",368,208,160,
"185",2007,"35-39",366,206,160,
"185",2007,"40-44",513,285,228,
"185",2007,"45-49",505,272,233,
"185",2007,"50-54",462,244,218,
"185",2007,"55-59",367,223,144,
"185",2007,"60-64",205,110,95,
"185",2007,"65-69",130,74,56,
"185",2007,"70-74",80,39,41,
"185",2007,"75-79",46,18,28,
"185",2007,"80-84",40,16,24,
"185",2007,"85+",19,7,12,
"188",2007,"0-4",798,415,383,
"188",2007,"5-9",689,350,339,
"188",2007,"10-14",721,340,381,
"188",2007,"15-19",855,465,390,
"188",2007,"20-24",697,368,329,
"188",2007,"25-29",432,216,216,
"188",2007,"30-34",459,258,201,
"188",2007,"35-39",407,237,170,
"188",2007,"40-44",505,278,227,
"188",2007,"45-49",471,277,194,
"188",2007,"50-54",451,272,179,
"188",2007,"55-59",317,188,129,
"188",2007,"60-64",218,111,107,
"188",2007,"65-69",120,70,50,
"188",2007,"70-74",116,58,58,
"188",2007,"75-79",84,35,49,
"188",2007,"80-84",53,18,35,
"188",2007,"85+",28,10,18,
"195",2007,"0-4",208,104,104,
"195",2007,"5-9",285,146,139,
"195",2007,"10-14",313,166,147,
"195",2007,"15-19",330,167,163,
"195",2007,"20-24",203,116,87,
"195",2007,"25-29",173,87,86,
"195",2007,"30-34",228,122,106,
"195",2007,"35-39",277,145,132,
"195",2007,"40-44",284,144,140,
"195",2007,"45-49",386,196,190,
"195",2007,"50-54",354,189,165,
"195",2007,"55-59",318,173,145,
"195",2007,"60-64",235,130,105,
"195",2007,"65-69",150,92,58,
"195",2007,"70-74",77,42,35,
"195",2007,"75-79",74,35,39,
"195",2007,"80-84",60,28,32,
"195",2007,"85+",38,19,19,
"198",2007,"0-4",315,165,150,
"198",2007,"5-9",415,213,202,
"198",2007,"10-14",432,238,194,
"198",2007,"15-19",407,220,187,
"198",2007,"20-24",316,173,143,
"198",2007,"25-29",196,112,84,
"198",2007,"30-34",281,142,139,
"198",2007,"35-39",331,166,165,
"198",2007,"40-44",428,228,200,
"198",2007,"45-49",507,289,218,
"198",2007,"50-54",501,280,221,
"198",2007,"55-59",447,257,190,
"198",2007,"60-64",322,197,125,
"198",2007,"65-69",213,130,83,
"198",2007,"70-74",119,78,41,
"198",2007,"75-79",82,46,36,
"198",2007,"80-84",41,18,23,
"198",2007,"85+",21,9,12,
"220",2007,"0-4",582,316,266,
"220",2007,"5-9",547,295,252,
"220",2007,"10-14",587,301,286,
"220",2007,"15-19",621,318,303,
"220",2007,"20-24",553,273,280,
"220",2007,"25-29",511,283,228,
"220",2007,"30-34",562,281,281,
"220",2007,"35-39",633,324,309,
"220",2007,"40-44",606,333,273,
"220",2007,"45-49",727,370,357,
"220",2007,"50-54",765,387,378,
"220",2007,"55-59",638,336,302,
"220",2007,"60-64",431,232,199,
"220",2007,"65-69",319,169,150,
"220",2007,"70-74",223,95,128,
"220",2007,"75-79",141,68,73,
"220",2007,"80-84",125,43,82,
"220",2007,"85+",107,32,75,
"230",2007,"0-4",31,19,12,
"230",2007,"5-9",31,15,16,
"230",2007,"10-14",49,23,26,
"230",2007,"15-19",37,19,18,
"230",2007,"20-24",29,14,15,
"230",2007,"25-29",65,31,34,
"230",2007,"30-34",104,46,58,
"230",2007,"35-39",67,42,25,
"230",2007,"40-44",85,48,37,
"230",2007,"45-49",70,37,33,
"230",2007,"50-54",98,58,40,
"230",2007,"55-59",93,50,43,
"230",2007,"60-64",62,32,30,
"230",2007,"65-69",32,16,16,
"230",2007,"70-74",21,13,8,
"230",2007,"75-79",11,3,8,
"230",2007,"80-84",10,4,6,
"230",2007,"85+",5,2,3,
"240",2007,"0-4",418,186,232,
"240",2007,"5-9",447,235,212,
"240",2007,"10-14",549,267,282,
"240",2007,"15-19",575,267,308,
"240",2007,"20-24",453,246,207,
"240",2007,"25-29",240,113,127,
"240",2007,"30-34",412,203,209,
"240",2007,"35-39",396,187,209,
"240",2007,"40-44",488,253,235,
"240",2007,"45-49",570,320,250,
"240",2007,"50-54",623,330,293,
"240",2007,"55-59",510,292,218,
"240",2007,"60-64",301,177,124,
"240",2007,"65-69",264,170,94,
"240",2007,"70-74",147,72,75,
"240",2007,"75-79",91,44,47,
"240",2007,"80-84",49,27,22,
"240",2007,"85+",36,8,28,
"261",2007,"0-4",603,300,303,
"261",2007,"5-9",659,335,324,
"261",2007,"10-14",735,368,367,
"261",2007,"15-19",829,441,388,
"261",2007,"20-24",663,358,305,
"261",2007,"25-29",377,250,127,
"261",2007,"30-34",518,233,285,
"261",2007,"35-39",645,345,300,
"261",2007,"40-44",777,409,368,
"261",2007,"45-49",1005,526,479,
"261",2007,"50-54",1026,556,470,
"261",2007,"55-59",803,467,336,
"261",2007,"60-64",488,295,193,
"261",2007,"65-69",279,151,128,
"261",2007,"70-74",170,93,77,
"261",2007,"75-79",124,64,60,
"261",2007,"80-84",70,31,39,
"261",2007,"85+",47,15,32,
"270",2007,"0-4",948,504,444,
"270",2007,"5-9",634,343,291,
"270",2007,"10-14",954,493,461,
"270",2007,"15-19",980,507,473,
"270",2007,"20-24",690,357,333,
"270",2007,"25-29",332,169,163,
"270",2007,"30-34",392,195,197,
"270",2007,"35-39",413,222,191,
"270",2007,"40-44",426,231,195,
"270",2007,"45-49",416,217,199,
"270",2007,"50-54",309,181,128,
"270",2007,"55-59",273,145,128,
"270",2007,"60-64",183,94,89,
"270",2007,"65-69",110,60,50,
"270",2007,"70-74",137,61,76,
"270",2007,"75-79",60,24,36,
"270",2007,"80-84",48,25,23,
"270",2007,"85+",27,9,18,
"275",2007,"0-4",107,48,59,
"275",2007,"5-9",148,74,74,
"275",2007,"10-14",166,88,78,
"275",2007,"15-19",191,108,83,
"275",2007,"20-24",100,57,43,
"275",2007,"25-29",68,37,31,
"275",2007,"30-34",86,36,50,
"275",2007,"35-39",120,58,62,
"275",2007,"40-44",147,68,79,
"275",2007,"45-49",223,119,104,
"275",2007,"50-54",237,130,107,
"275",2007,"55-59",203,104,99,
"275",2007,"60-64",171,95,76,
"275",2007,"65-69",117,65,52,
"275",2007,"70-74",91,50,41,
"275",2007,"75-79",66,34,32,
"275",2007,"80-84",39,18,21,
"275",2007,"85+",36,14,22,
"282",2007,"0-4",36,20,16,
"282",2007,"5-9",32,19,13,
"282",2007,"10-14",68,38,30,
"282",2007,"15-19",50,25,25,
"282",2007,"20-24",45,28,17,
"282",2007,"25-29",17,14,3,
"282",2007,"30-34",35,20,15,
"282",2007,"35-39",57,35,22,
"282",2007,"40-44",56,35,21,
"282",2007,"45-49",71,53,18,
"282",2007,"50-54",61,42,19,
"282",2007,"55-59",48,26,22,
"282",2007,"60-64",40,24,16,
"282",2007,"65-69",23,12,11,
"282",2007,"70-74",15,8,7,
"282",2007,"75-79",10,4,6,
"282",2007,"80-84",10,3,7,
"282",2007,"85+",3,1,2,
"290",2007,"0-4",389,206,183,
"290",2007,"5-9",399,205,194,
"290",2007,"10-14",503,252,251,
"290",2007,"15-19",640,361,279,
"290",2007,"20-24",445,240,205,
"290",2007,"25-29",217,150,67,
"290",2007,"30-34",283,163,120,
"290",2007,"35-39",286,133,153,
"290",2007,"40-44",421,226,195,
"290",2007,"45-49",442,228,214,
"290",2007,"50-54",494,284,210,
"290",2007,"55-59",432,251,181,
"290",2007,"60-64",269,153,116,
"290",2007,"65-69",179,101,78,
"290",2007,"70-74",127,76,51,
"290",2007,"75-79",105,56,49,
"290",2007,"80-84",56,31,25,
"290",2007,"85+",34,17,17,
"000",2008,"0-4",51819,26652,25167,
"000",2008,"5-9",48503,24834,23669,
"000",2008,"10-14",51301,26176,25125,
"000",2008,"15-19",54736,28424,26312,
"000",2008,"20-24",53107,28697,24410,
"000",2008,"25-29",47895,25507,22388,
"000",2008,"30-34",45518,23324,22194,
"000",2008,"35-39",46614,24038,22576,
"000",2008,"40-44",49293,25568,23725,
"000",2008,"45-49",56046,28678,27368,
"000",2008,"50-54",55774,28894,26880,
"000",2008,"55-59",46219,24641,21578,
"000",2008,"60-64",30767,16322,14445,
"000",2008,"65-69",18958,10022,8936,
"000",2008,"70-74",11889,5932,5957,
"000",2008,"75-79",8533,3963,4570,
"000",2008,"80-84",5546,2375,3171,
"000",2008,"85+",4300,1513,2787,
"013",2008,"0-4",86,38,48,
"013",2008,"5-9",65,23,42,
"013",2008,"10-14",85,31,54,
"013",2008,"15-19",86,48,38,
"013",2008,"20-24",192,133,59,
"013",2008,"25-29",252,180,72,
"013",2008,"30-34",160,98,62,
"013",2008,"35-39",222,167,55,
"013",2008,"40-44",371,260,111,
"013",2008,"45-49",381,261,120,
"013",2008,"50-54",320,206,114,
"013",2008,"55-59",251,161,90,
"013",2008,"60-64",134,76,58,
"013",2008,"65-69",56,36,20,
"013",2008,"70-74",26,14,12,
"013",2008,"75-79",17,11,6,
"013",2008,"80-84",14,11,3,
"013",2008,"85+",8,5,3,
"016",2008,"0-4",132,57,75,
"016",2008,"5-9",142,55,87,
"016",2008,"10-14",173,92,81,
"016",2008,"15-19",195,113,82,
"016",2008,"20-24",225,143,82,
"016",2008,"25-29",344,267,77,
"016",2008,"30-34",378,264,114,
"016",2008,"35-39",527,385,142,
"016",2008,"40-44",602,423,179,
"016",2008,"45-49",580,393,187,
"016",2008,"50-54",568,414,154,
"016",2008,"55-59",426,277,149,
"016",2008,"60-64",217,135,82,
"016",2008,"65-69",99,65,34,
"016",2008,"70-74",29,15,14,
"016",2008,"75-79",11,6,5,
"016",2008,"80-84",13,4,9,
"016",2008,"85+",8,1,7,
"020",2008,"0-4",21241,11006,10235,
"020",2008,"5-9",19908,10217,9691,
"020",2008,"10-14",20517,10449,10068,
"020",2008,"15-19",21490,11125,10365,
"020",2008,"20-24",22976,12251,10725,
"020",2008,"25-29",22199,11552,10647,
"020",2008,"30-34",19949,10174,9775,
"020",2008,"35-39",20023,10127,9896,
"020",2008,"40-44",20563,10380,10183,
"020",2008,"45-49",22939,11374,11565,
"020",2008,"50-54",22087,11071,11016,
"020",2008,"55-59",17948,9304,8644,
"020",2008,"60-64",12149,6278,5871,
"020",2008,"65-69",7044,3503,3541,
"020",2008,"70-74",4475,2080,2395,
"020",2008,"75-79",3374,1485,1889,
"020",2008,"80-84",2228,882,1346,
"020",2008,"85+",1761,591,1170,
"050",2008,"0-4",1834,939,895,
"050",2008,"5-9",1575,854,721,
"050",2008,"10-14",1763,939,824,
"050",2008,"15-19",1703,863,840,
"050",2008,"20-24",1353,735,618,
"050",2008,"25-29",1011,522,489,
"050",2008,"30-34",969,502,467,
"050",2008,"35-39",916,478,438,
"050",2008,"40-44",1090,616,474,
"050",2008,"45-49",1138,653,485,
"050",2008,"50-54",964,546,418,
"050",2008,"55-59",839,452,387,
"050",2008,"60-64",510,266,244,
"050",2008,"65-69",357,186,171,
"050",2008,"70-74",238,125,113,
"050",2008,"75-79",192,85,107,
"050",2008,"80-84",97,45,52,
"050",2008,"85+",75,32,43,
"060",2008,"0-4",51,27,24,
"060",2008,"5-9",67,33,34,
"060",2008,"10-14",79,37,42,
"060",2008,"15-19",93,56,37,
"060",2008,"20-24",55,30,25,
"060",2008,"25-29",43,23,20,
"060",2008,"30-34",53,31,22,
"060",2008,"35-39",61,34,27,
"060",2008,"40-44",81,44,37,
"060",2008,"45-49",154,85,69,
"060",2008,"50-54",94,48,46,
"060",2008,"55-59",98,57,41,
"060",2008,"60-64",48,33,15,
"060",2008,"65-69",34,19,15,
"060",2008,"70-74",16,8,8,
"060",2008,"75-79",14,9,5,
"060",2008,"80-84",5,2,3,
"060",2008,"85+",4,0,4,
"068",2008,"0-4",93,55,38,
"068",2008,"5-9",94,57,37,
"068",2008,"10-14",111,49,62,
"068",2008,"15-19",106,64,42,
"068",2008,"20-24",52,31,21,
"068",2008,"25-29",53,31,22,
"068",2008,"30-34",138,77,61,
"068",2008,"35-39",134,76,58,
"068",2008,"40-44",144,84,60,
"068",2008,"45-49",209,121,88,
"068",2008,"50-54",183,115,68,
"068",2008,"55-59",197,114,83,
"068",2008,"60-64",89,55,34,
"068",2008,"65-69",70,51,19,
"068",2008,"70-74",20,9,11,
"068",2008,"75-79",14,11,3,
"068",2008,"80-84",6,4,2,
"068",2008,"85+",4,2,2,
"070",2008,"0-4",410,217,193,
"070",2008,"5-9",395,209,186,
"070",2008,"10-14",479,253,226,
"070",2008,"15-19",529,266,263,
"070",2008,"20-24",366,190,176,
"070",2008,"25-29",227,124,103,
"070",2008,"30-34",250,123,127,
"070",2008,"35-39",240,135,105,
"070",2008,"40-44",312,156,156,
"070",2008,"45-49",366,181,185,
"070",2008,"50-54",373,211,162,
"070",2008,"55-59",298,148,150,
"070",2008,"60-64",162,94,68,
"070",2008,"65-69",125,62,63,
"070",2008,"70-74",83,47,36,
"070",2008,"75-79",69,39,30,
"070",2008,"80-84",29,13,16,
"070",2008,"85+",26,13,13,
"090",2008,"0-4",8015,4099,3916,
"090",2008,"5-9",6873,3438,3435,
"090",2008,"10-14",6450,3279,3171,
"090",2008,"15-19",7135,3662,3473,
"090",2008,"20-24",9515,5365,4150,
"090",2008,"25-29",9044,5016,4028,
"090",2008,"30-34",7341,3784,3557,
"090",2008,"35-39",6535,3349,3186,
"090",2008,"40-44",6290,3238,3052,
"090",2008,"45-49",6798,3341,3457,
"090",2008,"50-54",6925,3491,3434,
"090",2008,"55-59",5929,3249,2680,
"090",2008,"60-64",3844,2068,1776,
"090",2008,"65-69",2266,1195,1071,
"090",2008,"70-74",1380,719,661,
"090",2008,"75-79",949,466,483,
"090",2008,"80-84",641,272,369,
"090",2008,"85+",493,169,324,
"100",2008,"0-4",114,53,61,
"100",2008,"5-9",136,60,76,
"100",2008,"10-14",145,86,59,
"100",2008,"15-19",149,69,80,
"100",2008,"20-24",105,56,49,
"100",2008,"25-29",86,39,47,
"100",2008,"30-34",114,59,55,
"100",2008,"35-39",156,75,81,
"100",2008,"40-44",164,85,79,
"100",2008,"45-49",225,120,105,
"100",2008,"50-54",264,143,121,
"100",2008,"55-59",291,146,145,
"100",2008,"60-64",208,105,103,
"100",2008,"65-69",100,56,44,
"100",2008,"70-74",80,42,38,
"100",2008,"75-79",59,22,37,
"100",2008,"80-84",37,23,14,
"100",2008,"85+",31,14,17,
"105",2008,"0-4",122,65,57,
"105",2008,"5-9",105,42,63,
"105",2008,"10-14",134,68,66,
"105",2008,"15-19",159,84,75,
"105",2008,"20-24",109,63,46,
"105",2008,"25-29",95,57,38,
"105",2008,"30-34",101,53,48,
"105",2008,"35-39",104,58,46,
"105",2008,"40-44",155,86,69,
"105",2008,"45-49",192,108,84,
"105",2008,"50-54",216,115,101,
"105",2008,"55-59",229,127,102,
"105",2008,"60-64",171,104,67,
"105",2008,"65-69",118,70,48,
"105",2008,"70-74",71,47,24,
"105",2008,"75-79",41,28,13,
"105",2008,"80-84",19,11,8,
"105",2008,"85+",18,4,14,
"110",2008,"0-4",1861,946,915,
"110",2008,"5-9",1938,979,959,
"110",2008,"10-14",2016,1025,991,
"110",2008,"15-19",2376,1209,1167,
"110",2008,"20-24",1971,1042,929,
"110",2008,"25-29",1839,914,925,
"110",2008,"30-34",1923,958,965,
"110",2008,"35-39",2151,1142,1009,
"110",2008,"40-44",2353,1175,1178,
"110",2008,"45-49",2767,1408,1359,
"110",2008,"50-54",2909,1466,1443,
"110",2008,"55-59",2543,1305,1238,
"110",2008,"60-64",1553,834,719,
"110",2008,"65-69",893,438,455,
"110",2008,"70-74",559,286,273,
"110",2008,"75-79",370,151,219,
"110",2008,"80-84",278,112,166,
"110",2008,"85+",254,90,164,
"122",2008,"0-4",3184,1559,1625,
"122",2008,"5-9",3357,1689,1668,
"122",2008,"10-14",3795,1929,1866,
"122",2008,"15-19",4310,2232,2078,
"122",2008,"20-24",3377,1901,1476,
"122",2008,"25-29",2333,1303,1030,
"122",2008,"30-34",2878,1464,1414,
"122",2008,"35-39",3361,1735,1626,
"122",2008,"40-44",3656,1919,1737,
"122",2008,"45-49",4694,2409,2285,
"122",2008,"50-54",5376,2735,2641,
"122",2008,"55-59",4526,2441,2085,
"122",2008,"60-64",3231,1745,1486,
"122",2008,"65-69",2216,1222,994,
"122",2008,"70-74",1333,696,637,
"122",2008,"75-79",967,478,489,
"122",2008,"80-84",597,281,316,
"122",2008,"85+",478,182,296,
"130",2008,"0-4",866,437,429,
"130",2008,"5-9",849,450,399,
"130",2008,"10-14",915,459,456,
"130",2008,"15-19",1010,518,492,
"130",2008,"20-24",834,445,389,
"130",2008,"25-29",765,421,344,
"130",2008,"30-34",741,385,356,
"130",2008,"35-39",880,418,462,
"130",2008,"40-44",981,523,458,
"130",2008,"45-49",1224,626,598,
"130",2008,"50-54",1180,622,558,
"130",2008,"55-59",1052,550,502,
"130",2008,"60-64",746,378,368,
"130",2008,"65-69",451,243,208,
"130",2008,"70-74",266,133,133,
"130",2008,"75-79",222,93,129,
"130",2008,"80-84",166,82,84,
"130",2008,"85+",139,47,92,
"150",2008,"0-4",1071,546,525,
"150",2008,"5-9",1100,569,531,
"150",2008,"10-14",1111,581,530,
"150",2008,"15-19",1149,611,538,
"150",2008,"20-24",931,537,394,
"150",2008,"25-29",897,495,402,
"150",2008,"30-34",938,489,449,
"150",2008,"35-39",992,530,462,
"150",2008,"40-44",1047,520,527,
"150",2008,"45-49",1107,611,496,
"150",2008,"50-54",1071,588,483,
"150",2008,"55-59",816,440,376,
"150",2008,"60-64",562,300,262,
"150",2008,"65-69",346,176,170,
"150",2008,"70-74",240,124,116,
"150",2008,"75-79",103,50,53,
"150",2008,"80-84",76,29,47,
"150",2008,"85+",68,30,38,
"164",2008,"0-4",123,63,60,
"164",2008,"5-9",108,53,55,
"164",2008,"10-14",155,83,72,
"164",2008,"15-19",169,82,87,
"164",2008,"20-24",138,68,70,
"164",2008,"25-29",92,50,42,
"164",2008,"30-34",83,45,38,
"164",2008,"35-39",66,40,26,
"164",2008,"40-44",112,65,47,
"164",2008,"45-49",152,90,62,
"164",2008,"50-54",125,69,56,
"164",2008,"55-59",91,49,42,
"164",2008,"60-64",58,30,28,
"164",2008,"65-69",47,25,22,
"164",2008,"70-74",32,18,14,
"164",2008,"75-79",21,12,9,
"164",2008,"80-84",9,7,2,
"164",2008,"85+",9,2,7,
"170",2008,"0-4",6377,3313,3064,
"170",2008,"5-9",6100,3114,2986,
"170",2008,"10-14",7020,3592,3428,
"170",2008,"15-19",7160,3754,3406,
"170",2008,"20-24",5476,2863,2613,
"170",2008,"25-29",4599,2325,2274,
"170",2008,"30-34",5151,2562,2589,
"170",2008,"35-39",5793,2927,2866,
"170",2008,"40-44",6236,3209,3027,
"170",2008,"45-49",7294,3739,3555,
"170",2008,"50-54",7054,3740,3314,
"170",2008,"55-59",5570,2950,2620,
"170",2008,"60-64",3627,1873,1754,
"170",2008,"65-69",2503,1372,1131,
"170",2008,"70-74",1521,770,751,
"170",2008,"75-79",1103,551,552,
"170",2008,"80-84",643,288,355,
"170",2008,"85+",464,164,300,
"180",2008,"0-4",989,521,468,
"180",2008,"5-9",812,434,378,
"180",2008,"10-14",895,466,429,
"180",2008,"15-19",953,492,461,
"180",2008,"20-24",770,413,357,
"180",2008,"25-29",591,339,252,
"180",2008,"30-34",662,346,316,
"180",2008,"35-39",524,291,233,
"180",2008,"40-44",613,350,263,
"180",2008,"45-49",635,356,279,
"180",2008,"50-54",624,347,277,
"180",2008,"55-59",499,289,210,
"180",2008,"60-64",326,174,152,
"180",2008,"65-69",217,130,87,
"180",2008,"70-74",145,85,60,
"180",2008,"75-79",99,37,62,
"180",2008,"80-84",73,34,39,
"180",2008,"85+",27,14,13,
"185",2008,"0-4",731,380,351,
"185",2008,"5-9",562,316,246,
"185",2008,"10-14",566,283,283,
"185",2008,"15-19",694,373,321,
"185",2008,"20-24",630,339,291,
"185",2008,"25-29",375,180,195,
"185",2008,"30-34",368,207,161,
"185",2008,"35-39",347,196,151,
"185",2008,"40-44",494,278,216,
"185",2008,"45-49",467,243,224,
"185",2008,"50-54",469,255,214,
"185",2008,"55-59",387,227,160,
"185",2008,"60-64",216,120,96,
"185",2008,"65-69",130,73,57,
"185",2008,"70-74",90,45,45,
"185",2008,"75-79",45,15,30,
"185",2008,"80-84",39,17,22,
"185",2008,"85+",23,9,14,
"188",2008,"0-4",832,435,397,
"188",2008,"5-9",676,337,339,
"188",2008,"10-14",708,337,371,
"188",2008,"15-19",832,453,379,
"188",2008,"20-24",671,357,314,
"188",2008,"25-29",502,250,252,
"188",2008,"30-34",422,251,171,
"188",2008,"35-39",408,229,179,
"188",2008,"40-44",473,259,214,
"188",2008,"45-49",487,286,201,
"188",2008,"50-54",468,276,192,
"188",2008,"55-59",328,196,132,
"188",2008,"60-64",231,119,112,
"188",2008,"65-69",120,69,51,
"188",2008,"70-74",109,59,50,
"188",2008,"75-79",94,38,56,
"188",2008,"80-84",56,19,37,
"188",2008,"85+",28,8,20,
"195",2008,"0-4",212,103,109,
"195",2008,"5-9",263,134,129,
"195",2008,"10-14",303,164,139,
"195",2008,"15-19",302,151,151,
"195",2008,"20-24",203,115,88,
"195",2008,"25-29",187,95,92,
"195",2008,"30-34",222,119,103,
"195",2008,"35-39",256,134,122,
"195",2008,"40-44",278,142,136,
"195",2008,"45-49",363,187,176,
"195",2008,"50-54",352,183,169,
"195",2008,"55-59",326,178,148,
"195",2008,"60-64",252,139,113,
"195",2008,"65-69",164,101,63,
"195",2008,"70-74",81,45,36,
"195",2008,"75-79",70,33,37,
"195",2008,"80-84",58,27,31,
"195",2008,"85+",39,19,20,
"198",2008,"0-4",360,189,171,
"198",2008,"5-9",402,204,198,
"198",2008,"10-14",427,236,191,
"198",2008,"15-19",387,214,173,
"198",2008,"20-24",310,166,144,
"198",2008,"25-29",229,128,101,
"198",2008,"30-34",287,148,139,
"198",2008,"35-39",333,166,167,
"198",2008,"40-44",407,218,189,
"198",2008,"45-49",495,280,215,
"198",2008,"50-54",497,274,223,
"198",2008,"55-59",473,269,204,
"198",2008,"60-64",336,206,130,
"198",2008,"65-69",231,140,91,
"198",2008,"70-74",125,81,44,
"198",2008,"75-79",86,49,37,
"198",2008,"80-84",42,19,23,
"198",2008,"85+",25,12,13,
"220",2008,"0-4",604,330,274,
"220",2008,"5-9",563,309,254,
"220",2008,"10-14",548,274,274,
"220",2008,"15-19",599,320,279,
"220",2008,"20-24",512,240,272,
"220",2008,"25-29",572,308,264,
"220",2008,"30-34",559,286,273,
"220",2008,"35-39",619,322,297,
"220",2008,"40-44",586,325,261,
"220",2008,"45-49",691,356,335,
"220",2008,"50-54",786,392,394,
"220",2008,"55-59",664,341,323,
"220",2008,"60-64",449,247,202,
"220",2008,"65-69",308,169,139,
"220",2008,"70-74",246,105,141,
"220",2008,"75-79",153,69,84,
"220",2008,"80-84",123,46,77,
"220",2008,"85+",116,33,83,
"230",2008,"0-4",38,20,18,
"230",2008,"5-9",29,16,13,
"230",2008,"10-14",42,20,22,
"230",2008,"15-19",40,19,21,
"230",2008,"20-24",29,14,15,
"230",2008,"25-29",69,31,38,
"230",2008,"30-34",103,45,58,
"230",2008,"35-39",65,41,24,
"230",2008,"40-44",86,49,37,
"230",2008,"45-49",69,38,31,
"230",2008,"50-54",95,55,40,
"230",2008,"55-59",97,54,43,
"230",2008,"60-64",66,36,30,
"230",2008,"65-69",36,16,20,
"230",2008,"70-74",21,13,8,
"230",2008,"75-79",11,3,8,
"230",2008,"80-84",10,4,6,
"230",2008,"85+",5,2,3,
"240",2008,"0-4",437,191,246,
"240",2008,"5-9",467,250,217,
"240",2008,"10-14",550,265,285,
"240",2008,"15-19",550,259,291,
"240",2008,"20-24",415,201,214,
"240",2008,"25-29",287,144,143,
"240",2008,"30-34",418,203,215,
"240",2008,"35-39",433,213,220,
"240",2008,"40-44",480,249,231,
"240",2008,"45-49",552,321,231,
"240",2008,"50-54",626,318,308,
"240",2008,"55-59",528,305,223,
"240",2008,"60-64",334,202,132,
"240",2008,"65-69",273,174,99,
"240",2008,"70-74",156,81,75,
"240",2008,"75-79",92,45,47,
"240",2008,"80-84",58,30,28,
"240",2008,"85+",35,6,29,
"261",2008,"0-4",594,297,297,
"261",2008,"5-9",652,329,323,
"261",2008,"10-14",691,344,347,
"261",2008,"15-19",771,426,345,
"261",2008,"20-24",636,328,308,
"261",2008,"25-29",448,283,165,
"261",2008,"30-34",495,233,262,
"261",2008,"35-39",606,318,288,
"261",2008,"40-44",741,396,345,
"261",2008,"45-49",949,490,459,
"261",2008,"50-54",1025,566,459,
"261",2008,"55-59",815,461,354,
"261",2008,"60-64",532,318,214,
"261",2008,"65-69",318,185,133,
"261",2008,"70-74",169,86,83,
"261",2008,"75-79",112,57,55,
"261",2008,"80-84",73,34,39,
"261",2008,"85+",52,17,35,
"270",2008,"0-4",908,487,421,
"270",2008,"5-9",682,363,319,
"270",2008,"10-14",931,481,450,
"270",2008,"15-19",947,484,463,
"270",2008,"20-24",712,378,334,
"270",2008,"25-29",369,191,178,
"270",2008,"30-34",399,188,211,
"270",2008,"35-39",405,225,180,
"270",2008,"40-44",399,205,194,
"270",2008,"45-49",428,232,196,
"270",2008,"50-54",338,201,137,
"270",2008,"55-59",275,147,128,
"270",2008,"60-64",191,94,97,
"270",2008,"65-69",119,68,51,
"270",2008,"70-74",128,54,74,
"270",2008,"75-79",71,32,39,
"270",2008,"80-84",38,16,22,
"270",2008,"85+",36,15,21,
"275",2008,"0-4",115,53,62,
"275",2008,"5-9",146,71,75,
"275",2008,"10-14",164,87,77,
"275",2008,"15-19",180,101,79,
"275",2008,"20-24",107,62,45,
"275",2008,"25-29",84,44,40,
"275",2008,"30-34",87,38,49,
"275",2008,"35-39",121,59,62,
"275",2008,"40-44",142,64,78,
"275",2008,"45-49",213,115,98,
"275",2008,"50-54",242,131,111,
"275",2008,"55-59",217,112,105,
"275",2008,"60-64",183,101,82,
"275",2008,"65-69",121,66,55,
"275",2008,"70-74",99,55,44,
"275",2008,"75-79",66,35,31,
"275",2008,"80-84",40,20,20,
"275",2008,"85+",35,13,22,
"282",2008,"0-4",37,24,13,
"282",2008,"5-9",36,20,16,
"282",2008,"10-14",53,29,24,
"282",2008,"15-19",62,33,29,
"282",2008,"20-24",39,28,11,
"282",2008,"25-29",27,16,11,
"282",2008,"30-34",34,21,13,
"282",2008,"35-39",59,37,22,
"282",2008,"40-44",60,35,25,
"282",2008,"45-49",60,45,15,
"282",2008,"50-54",62,41,21,
"282",2008,"55-59",52,29,23,
"282",2008,"60-64",40,23,17,
"282",2008,"65-69",23,15,8,
"282",2008,"70-74",18,11,7,
"282",2008,"75-79",9,1,8,
"282",2008,"80-84",11,5,6,
"282",2008,"85+",4,1,3,
"290",2008,"0-4",382,202,180,
"290",2008,"5-9",401,209,192,
"290",2008,"10-14",475,238,237,
"290",2008,"15-19",600,343,257,
"290",2008,"20-24",398,203,195,
"290",2008,"25-29",276,179,97,
"290",2008,"30-34",295,171,124,
"290",2008,"35-39",277,131,146,
"290",2008,"40-44",377,215,162,
"290",2008,"45-49",417,209,208,
"290",2008,"50-54",481,275,206,
"290",2008,"55-59",454,263,191,
"290",2008,"60-64",302,169,133,
"290",2008,"65-69",173,97,76,
"290",2008,"70-74",133,79,54,
"290",2008,"75-79",99,52,47,
"290",2008,"80-84",67,38,29,
"290",2008,"85+",35,18,17,
"000",2009,"0-4",53109,27334,25775,
"000",2009,"5-9",49577,25387,24190,
"000",2009,"10-14",51036,26077,24959,
"000",2009,"15-19",53794,27900,25894,
"000",2009,"20-24",53670,29037,24633,
"000",2009,"25-29",51439,27252,24187,
"000",2009,"30-34",46457,23974,22483,
"000",2009,"35-39",46136,23722,22414,
"000",2009,"40-44",47666,24626,23040,
"000",2009,"45-49",55733,28715,27018,
"000",2009,"50-54",55887,28792,27095,
"000",2009,"55-59",48141,25548,22593,
"000",2009,"60-64",33076,17529,15547,
"000",2009,"65-69",20669,10924,9745,
"000",2009,"70-74",12488,6275,6213,
"000",2009,"75-79",8691,4034,4657,
"000",2009,"80-84",5755,2486,3269,
"000",2009,"85+",4504,1588,2916,
"013",2009,"0-4",103,48,55,
"013",2009,"5-9",78,31,47,
"013",2009,"10-14",85,28,57,
"013",2009,"15-19",85,44,41,
"013",2009,"20-24",212,150,62,
"013",2009,"25-29",281,191,90,
"013",2009,"30-34",182,107,75,
"013",2009,"35-39",229,164,65,
"013",2009,"40-44",355,253,102,
"013",2009,"45-49",414,279,135,
"013",2009,"50-54",329,207,122,
"013",2009,"55-59",267,176,91,
"013",2009,"60-64",147,85,62,
"013",2009,"65-69",68,45,23,
"013",2009,"70-74",33,17,16,
"013",2009,"75-79",17,10,7,
"013",2009,"80-84",14,10,4,
"013",2009,"85+",9,6,3,
"016",2009,"0-4",156,64,92,
"016",2009,"5-9",155,60,95,
"016",2009,"10-14",170,91,79,
"016",2009,"15-19",209,117,92,
"016",2009,"20-24",243,166,77,
"016",2009,"25-29",397,286,111,
"016",2009,"30-34",391,278,113,
"016",2009,"35-39",482,351,131,
"016",2009,"40-44",588,403,185,
"016",2009,"45-49",598,413,185,
"016",2009,"50-54",583,414,169,
"016",2009,"55-59",458,301,157,
"016",2009,"60-64",238,148,90,
"016",2009,"65-69",105,69,36,
"016",2009,"70-74",57,30,27,
"016",2009,"75-79",14,9,5,
"016",2009,"80-84",11,4,7,
"016",2009,"85+",7,1,6,
"020",2009,"0-4",21813,11282,10531,
"020",2009,"5-9",20442,10530,9912,
"020",2009,"10-14",20573,10432,10141,
"020",2009,"15-19",21623,11222,10401,
"020",2009,"20-24",23792,12694,11098,
"020",2009,"25-29",23653,12258,11395,
"020",2009,"30-34",20469,10524,9945,
"020",2009,"35-39",19943,10051,9892,
"020",2009,"40-44",19964,10026,9938,
"020",2009,"45-49",23012,11574,11438,
"020",2009,"50-54",22225,11010,11215,
"020",2009,"55-59",18648,9649,8999,
"020",2009,"60-64",12973,6691,6282,
"020",2009,"65-69",7786,3876,3910,
"020",2009,"70-74",4728,2231,2497,
"020",2009,"75-79",3414,1493,1921,
"020",2009,"80-84",2296,919,1377,
"020",2009,"85+",1876,632,1244,
"050",2009,"0-4",1816,933,883,
"050",2009,"5-9",1651,885,766,
"050",2009,"10-14",1717,914,803,
"050",2009,"15-19",1670,845,825,
"050",2009,"20-24",1303,706,597,
"050",2009,"25-29",1117,588,529,
"050",2009,"30-34",1004,519,485,
"050",2009,"35-39",878,457,421,
"050",2009,"40-44",1018,575,443,
"050",2009,"45-49",1168,668,500,
"050",2009,"50-54",998,556,442,
"050",2009,"55-59",848,470,378,
"050",2009,"60-64",548,285,263,
"050",2009,"65-69",399,210,189,
"050",2009,"70-74",217,120,97,
"050",2009,"75-79",192,82,110,
"050",2009,"80-84",105,48,57,
"050",2009,"85+",76,34,42,
"060",2009,"0-4",46,29,17,
"060",2009,"5-9",61,30,31,
"060",2009,"10-14",76,34,42,
"060",2009,"15-19",74,46,28,
"060",2009,"20-24",49,28,21,
"060",2009,"25-29",51,26,25,
"060",2009,"30-34",44,28,16,
"060",2009,"35-39",61,33,28,
"060",2009,"40-44",68,36,32,
"060",2009,"45-49",133,71,62,
"060",2009,"50-54",102,54,48,
"060",2009,"55-59",95,55,40,
"060",2009,"60-64",59,38,21,
"060",2009,"65-69",28,16,12,
"060",2009,"70-74",21,10,11,
"060",2009,"75-79",16,10,6,
"060",2009,"80-84",7,4,3,
"060",2009,"85+",4,0,4,
"068",2009,"0-4",104,61,43,
"068",2009,"5-9",100,58,42,
"068",2009,"10-14",118,58,60,
"068",2009,"15-19",105,62,43,
"068",2009,"20-24",50,30,20,
"068",2009,"25-29",79,46,33,
"068",2009,"30-34",142,78,64,
"068",2009,"35-39",132,71,61,
"068",2009,"40-44",135,79,56,
"068",2009,"45-49",214,122,92,
"068",2009,"50-54",181,114,67,
"068",2009,"55-59",196,117,79,
"068",2009,"60-64",101,64,37,
"068",2009,"65-69",75,50,25,
"068",2009,"70-74",28,15,13,
"068",2009,"75-79",19,16,3,
"068",2009,"80-84",7,4,3,
"068",2009,"85+",2,1,1,
"070",2009,"0-4",423,227,196,
"070",2009,"5-9",389,204,185,
"070",2009,"10-14",460,248,212,
"070",2009,"15-19",495,246,249,
"070",2009,"20-24",366,185,181,
"070",2009,"25-29",261,141,120,
"070",2009,"30-34",244,121,123,
"070",2009,"35-39",221,128,93,
"070",2009,"40-44",291,140,151,
"070",2009,"45-49",360,188,172,
"070",2009,"50-54",380,207,173,
"070",2009,"55-59",319,161,158,
"070",2009,"60-64",163,92,71,
"070",2009,"65-69",129,63,66,
"070",2009,"70-74",90,53,37,
"070",2009,"75-79",61,36,25,
"070",2009,"80-84",38,18,20,
"070",2009,"85+",26,14,12,
"090",2009,"0-4",8004,4097,3907,
"090",2009,"5-9",6836,3418,3418,
"090",2009,"10-14",6368,3261,3107,
"090",2009,"15-19",6970,3548,3422,
"090",2009,"20-24",9788,5553,4235,
"090",2009,"25-29",8915,4921,3994,
"090",2009,"30-34",7272,3752,3520,
"090",2009,"35-39",6442,3316,3126,
"090",2009,"40-44",6011,3060,2951,
"090",2009,"45-49",6743,3340,3403,
"090",2009,"50-54",6974,3535,3439,
"090",2009,"55-59",6125,3299,2826,
"090",2009,"60-64",4143,2242,1901,
"090",2009,"65-69",2477,1323,1154,
"090",2009,"70-74",1418,733,685,
"090",2009,"75-79",960,446,514,
"090",2009,"80-84",679,307,372,
"090",2009,"85+",506,173,333,
"100",2009,"0-4",114,54,60,
"100",2009,"5-9",133,58,75,
"100",2009,"10-14",144,87,57,
"100",2009,"15-19",141,65,76,
"100",2009,"20-24",83,47,36,
"100",2009,"25-29",93,42,51,
"100",2009,"30-34",117,57,60,
"100",2009,"35-39",138,67,71,
"100",2009,"40-44",171,87,84,
"100",2009,"45-49",227,119,108,
"100",2009,"50-54",253,133,120,
"100",2009,"55-59",283,147,136,
"100",2009,"60-64",228,120,108,
"100",2009,"65-69",120,61,59,
"100",2009,"70-74",75,41,34,
"100",2009,"75-79",67,25,42,
"100",2009,"80-84",35,22,13,
"100",2009,"85+",31,12,19,
"105",2009,"0-4",129,72,57,
"105",2009,"5-9",107,42,65,
"105",2009,"10-14",122,58,64,
"105",2009,"15-19",149,83,66,
"105",2009,"20-24",102,59,43,
"105",2009,"25-29",110,66,44,
"105",2009,"30-34",109,55,54,
"105",2009,"35-39",103,53,50,
"105",2009,"40-44",141,83,58,
"105",2009,"45-49",189,104,85,
"105",2009,"50-54",212,115,97,
"105",2009,"55-59",233,126,107,
"105",2009,"60-64",183,112,71,
"105",2009,"65-69",123,73,50,
"105",2009,"70-74",75,48,27,
"105",2009,"75-79",43,31,12,
"105",2009,"80-84",17,10,7,
"105",2009,"85+",19,5,14,
"110",2009,"0-4",1930,985,945,
"110",2009,"5-9",1942,984,958,
"110",2009,"10-14",2012,1030,982,
"110",2009,"15-19",2309,1167,1142,
"110",2009,"20-24",1959,1020,939,
"110",2009,"25-29",2058,1035,1023,
"110",2009,"30-34",1944,992,952,
"110",2009,"35-39",2076,1068,1008,
"110",2009,"40-44",2344,1200,1144,
"110",2009,"45-49",2729,1387,1342,
"110",2009,"50-54",2856,1462,1394,
"110",2009,"55-59",2586,1312,1274,
"110",2009,"60-64",1705,894,811,
"110",2009,"65-69",982,491,491,
"110",2009,"70-74",614,311,303,
"110",2009,"75-79",362,151,211,
"110",2009,"80-84",295,115,180,
"110",2009,"85+",243,87,156,
"122",2009,"0-4",3330,1627,1703,
"122",2009,"5-9",3409,1740,1669,
"122",2009,"10-14",3768,1879,1889,
"122",2009,"15-19",4173,2207,1966,
"122",2009,"20-24",3235,1787,1448,
"122",2009,"25-29",2788,1523,1265,
"122",2009,"30-34",2954,1517,1437,
"122",2009,"35-39",3345,1742,1603,
"122",2009,"40-44",3536,1850,1686,
"122",2009,"45-49",4610,2352,2258,
"122",2009,"50-54",5230,2681,2549,
"122",2009,"55-59",4849,2577,2272,
"122",2009,"60-64",3468,1861,1607,
"122",2009,"65-69",2407,1336,1071,
"122",2009,"70-74",1405,737,668,
"122",2009,"75-79",992,505,487,
"122",2009,"80-84",634,294,340,
"122",2009,"85+",499,189,310,
"130",2009,"0-4",885,445,440,
"130",2009,"5-9",846,455,391,
"130",2009,"10-14",888,433,455,
"130",2009,"15-19",978,508,470,
"130",2009,"20-24",814,452,362,
"130",2009,"25-29",890,475,415,
"130",2009,"30-34",782,401,381,
"130",2009,"35-39",848,414,434,
"130",2009,"40-44",916,478,438,
"130",2009,"45-49",1195,621,574,
"130",2009,"50-54",1166,605,561,
"130",2009,"55-59",1085,560,525,
"130",2009,"60-64",777,399,378,
"130",2009,"65-69",489,259,230,
"130",2009,"70-74",296,148,148,
"130",2009,"75-79",206,95,111,
"130",2009,"80-84",164,76,88,
"130",2009,"85+",152,53,99,
"150",2009,"0-4",1119,572,547,
"150",2009,"5-9",1036,531,505,
"150",2009,"10-14",1126,603,523,
"150",2009,"15-19",1059,560,499,
"150",2009,"20-24",955,557,398,
"150",2009,"25-29",973,545,428,
"150",2009,"30-34",944,476,468,
"150",2009,"35-39",937,500,437,
"150",2009,"40-44",970,486,484,
"150",2009,"45-49",1109,606,503,
"150",2009,"50-54",1050,570,480,
"150",2009,"55-59",853,464,389,
"150",2009,"60-64",593,313,280,
"150",2009,"65-69",389,198,191,
"150",2009,"70-74",249,132,117,
"150",2009,"75-79",107,48,59,
"150",2009,"80-84",76,31,45,
"150",2009,"85+",71,32,39,
"164",2009,"0-4",123,62,61,
"164",2009,"5-9",112,57,55,
"164",2009,"10-14",153,77,76,
"164",2009,"15-19",156,78,78,
"164",2009,"20-24",124,62,62,
"164",2009,"25-29",118,62,56,
"164",2009,"30-34",88,52,36,
"164",2009,"35-39",68,35,33,
"164",2009,"40-44",104,63,41,
"164",2009,"45-49",143,85,58,
"164",2009,"50-54",122,70,52,
"164",2009,"55-59",103,51,52,
"164",2009,"60-64",56,30,26,
"164",2009,"65-69",54,29,25,
"164",2009,"70-74",31,18,13,
"164",2009,"75-79",18,11,7,
"164",2009,"80-84",15,8,7,
"164",2009,"85+",9,2,7,
"170",2009,"0-4",6591,3433,3158,
"170",2009,"5-9",6563,3342,3221,
"170",2009,"10-14",7076,3654,3422,
"170",2009,"15-19",7072,3635,3437,
"170",2009,"20-24",5262,2771,2491,
"170",2009,"25-29",5207,2659,2548,
"170",2009,"30-34",5350,2696,2654,
"170",2009,"35-39",5901,2974,2927,
"170",2009,"40-44",6132,3136,2996,
"170",2009,"45-49",7227,3717,3510,
"170",2009,"50-54",7169,3771,3398,
"170",2009,"55-59",5949,3129,2820,
"170",2009,"60-64",3943,2054,1889,
"170",2009,"65-69",2718,1472,1246,
"170",2009,"70-74",1582,802,780,
"170",2009,"75-79",1163,582,581,
"170",2009,"80-84",677,307,370,
"170",2009,"85+",492,173,319,
"180",2009,"0-4",1041,552,489,
"180",2009,"5-9",827,434,393,
"180",2009,"10-14",852,453,399,
"180",2009,"15-19",933,486,447,
"180",2009,"20-24",761,402,359,
"180",2009,"25-29",650,365,285,
"180",2009,"30-34",635,335,300,
"180",2009,"35-39",548,305,243,
"180",2009,"40-44",566,318,248,
"180",2009,"45-49",628,348,280,
"180",2009,"50-54",607,348,259,
"180",2009,"55-59",521,290,231,
"180",2009,"60-64",348,198,150,
"180",2009,"65-69",224,130,94,
"180",2009,"70-74",146,84,62,
"180",2009,"75-79",101,41,60,
"180",2009,"80-84",72,30,42,
"180",2009,"85+",32,18,14,
"185",2009,"0-4",745,386,359,
"185",2009,"5-9",599,328,271,
"185",2009,"10-14",551,279,272,
"185",2009,"15-19",659,362,297,
"185",2009,"20-24",623,325,298,
"185",2009,"25-29",443,223,220,
"185",2009,"30-34",401,226,175,
"185",2009,"35-39",341,189,152,
"185",2009,"40-44",468,272,196,
"185",2009,"45-49",466,238,228,
"185",2009,"50-54",469,250,219,
"185",2009,"55-59",400,233,167,
"185",2009,"60-64",239,130,109,
"185",2009,"65-69",151,89,62,
"185",2009,"70-74",84,40,44,
"185",2009,"75-79",48,22,26,
"185",2009,"80-84",39,17,22,
"185",2009,"85+",23,10,13,
"188",2009,"0-4",851,446,405,
"188",2009,"5-9",679,332,347,
"188",2009,"10-14",699,339,360,
"188",2009,"15-19",765,420,345,
"188",2009,"20-24",699,369,330,
"188",2009,"25-29",508,256,252,
"188",2009,"30-34",440,250,190,
"188",2009,"35-39",387,215,172,
"188",2009,"40-44",472,270,202,
"188",2009,"45-49",469,279,190,
"188",2009,"50-54",457,262,195,
"188",2009,"55-59",328,201,127,
"188",2009,"60-64",266,137,129,
"188",2009,"65-69",129,72,57,
"188",2009,"70-74",107,59,48,
"188",2009,"75-79",100,43,57,
"188",2009,"80-84",55,17,38,
"188",2009,"85+",33,9,24,
"195",2009,"0-4",207,101,106,
"195",2009,"5-9",256,129,127,
"195",2009,"10-14",296,165,131,
"195",2009,"15-19",277,137,140,
"195",2009,"20-24",206,115,91,
"195",2009,"25-29",207,106,101,
"195",2009,"30-34",219,117,102,
"195",2009,"35-39",239,124,115,
"195",2009,"40-44",275,140,135,
"195",2009,"45-49",343,180,163,
"195",2009,"50-54",351,178,173,
"195",2009,"55-59",332,183,149,
"195",2009,"60-64",269,146,123,
"195",2009,"65-69",177,110,67,
"195",2009,"70-74",86,48,38,
"195",2009,"75-79",68,32,36,
"195",2009,"80-84",56,26,30,
"195",2009,"85+",40,20,20,
"198",2009,"0-4",387,203,184,
"198",2009,"5-9",376,189,187,
"198",2009,"10-14",424,235,189,
"198",2009,"15-19",369,210,159,
"198",2009,"20-24",308,161,147,
"198",2009,"25-29",269,147,122,
"198",2009,"30-34",296,155,141,
"198",2009,"35-39",336,167,169,
"198",2009,"40-44",390,209,181,
"198",2009,"45-49",485,273,212,
"198",2009,"50-54",495,269,226,
"198",2009,"55-59",502,284,218,
"198",2009,"60-64",351,216,135,
"198",2009,"65-69",249,150,99,
"198",2009,"70-74",132,85,47,
"198",2009,"75-79",89,51,38,
"198",2009,"80-84",42,19,23,
"198",2009,"85+",25,13,12,
"220",2009,"0-4",613,343,270,
"220",2009,"5-9",556,301,255,
"220",2009,"10-14",525,272,253,
"220",2009,"15-19",591,318,273,
"220",2009,"20-24",502,235,267,
"220",2009,"25-29",576,300,276,
"220",2009,"30-34",597,309,288,
"220",2009,"35-39",602,324,278,
"220",2009,"40-44",578,301,277,
"220",2009,"45-49",651,347,304,
"220",2009,"50-54",795,392,403,
"220",2009,"55-59",683,350,333,
"220",2009,"60-64",496,271,225,
"220",2009,"65-69",295,163,132,
"220",2009,"70-74",271,119,152,
"220",2009,"75-79",152,66,86,
"220",2009,"80-84",119,44,75,
"220",2009,"85+",128,34,94,
"230",2009,"0-4",45,25,20,
"230",2009,"5-9",30,15,15,
"230",2009,"10-14",39,19,20,
"230",2009,"15-19",43,19,24,
"230",2009,"20-24",33,16,17,
"230",2009,"25-29",74,33,41,
"230",2009,"30-34",104,46,58,
"230",2009,"35-39",65,41,24,
"230",2009,"40-44",91,51,40,
"230",2009,"45-49",69,37,32,
"230",2009,"50-54",93,52,41,
"230",2009,"55-59",101,58,43,
"230",2009,"60-64",69,39,30,
"230",2009,"65-69",40,17,23,
"230",2009,"70-74",22,14,8,
"230",2009,"75-79",10,3,7,
"230",2009,"80-84",10,4,6,
"230",2009,"85+",6,2,4,
"240",2009,"0-4",451,194,257,
"240",2009,"5-9",482,257,225,
"240",2009,"10-14",505,251,254,
"240",2009,"15-19",534,254,280,
"240",2009,"20-24",401,176,225,
"240",2009,"25-29",328,160,168,
"240",2009,"30-34",432,216,216,
"240",2009,"35-39",424,213,211,
"240",2009,"40-44",477,250,227,
"240",2009,"45-49",563,324,239,
"240",2009,"50-54",600,311,289,
"240",2009,"55-59",546,316,230,
"240",2009,"60-64",366,219,147,
"240",2009,"65-69",275,173,102,
"240",2009,"70-74",171,89,82,
"240",2009,"75-79",92,44,48,
"240",2009,"80-84",63,33,30,
"240",2009,"85+",33,6,27,
"261",2009,"0-4",594,297,297,
"261",2009,"5-9",612,313,299,
"261",2009,"10-14",686,334,352,
"261",2009,"15-19",725,395,330,
"261",2009,"20-24",557,296,261,
"261",2009,"25-29",505,307,198,
"261",2009,"30-34",496,244,252,
"261",2009,"35-39",548,289,259,
"261",2009,"40-44",703,372,331,
"261",2009,"45-49",878,461,417,
"261",2009,"50-54",1030,566,464,
"261",2009,"55-59",830,476,354,
"261",2009,"60-64",576,330,246,
"261",2009,"65-69",334,191,143,
"261",2009,"70-74",185,97,88,
"261",2009,"75-79",111,57,54,
"261",2009,"80-84",67,33,34,
"261",2009,"85+",57,18,39,
"270",2009,"0-4",916,496,420,
"270",2009,"5-9",725,375,350,
"270",2009,"10-14",924,486,438,
"270",2009,"15-19",884,456,428,
"270",2009,"20-24",698,368,330,
"270",2009,"25-29",433,220,213,
"270",2009,"30-34",376,188,188,
"270",2009,"35-39",394,206,188,
"270",2009,"40-44",395,209,186,
"270",2009,"45-49",437,232,205,
"270",2009,"50-54",351,200,151,
"270",2009,"55-59",272,149,123,
"270",2009,"60-64",206,110,96,
"270",2009,"65-69",125,67,58,
"270",2009,"70-74",110,47,63,
"270",2009,"75-79",80,35,45,
"270",2009,"80-84",39,18,21,
"270",2009,"85+",36,15,21,
"275",2009,"0-4",112,48,64,
"275",2009,"5-9",142,68,74,
"275",2009,"10-14",159,85,74,
"275",2009,"15-19",165,93,72,
"275",2009,"20-24",108,64,44,
"275",2009,"25-29",96,50,46,
"275",2009,"30-34",83,37,46,
"275",2009,"35-39",114,57,57,
"275",2009,"40-44",134,60,74,
"275",2009,"45-49",200,108,92,
"275",2009,"50-54",245,132,113,
"275",2009,"55-59",229,119,110,
"275",2009,"60-64",193,107,86,
"275",2009,"65-69",124,66,58,
"275",2009,"70-74",107,60,47,
"275",2009,"75-79",67,36,31,
"275",2009,"80-84",42,20,22,
"275",2009,"85+",32,11,21,
"282",2009,"0-4",46,28,18,
"282",2009,"5-9",44,26,18,
"282",2009,"10-14",51,27,24,
"282",2009,"15-19",61,34,27,
"282",2009,"20-24",49,32,17,
"282",2009,"25-29",38,22,16,
"282",2009,"30-34",43,27,16,
"282",2009,"35-39",57,35,22,
"282",2009,"40-44",56,33,23,
"282",2009,"45-49",63,41,22,
"282",2009,"50-54",64,43,21,
"282",2009,"55-59",57,36,21,
"282",2009,"60-64",46,24,22,
"282",2009,"65-69",22,15,7,
"282",2009,"70-74",20,10,10,
"282",2009,"75-79",11,3,8,
"282",2009,"80-84",11,5,6,
"282",2009,"85+",5,1,4,
"290",2009,"0-4",415,224,191,
"290",2009,"5-9",389,195,194,
"290",2009,"10-14",469,245,224,
"290",2009,"15-19",520,283,237,
"290",2009,"20-24",388,211,177,
"290",2009,"25-29",321,199,122,
"290",2009,"30-34",299,171,128,
"290",2009,"35-39",277,133,144,
"290",2009,"40-44",317,186,131,
"290",2009,"45-49",410,201,209,
"290",2009,"50-54",500,285,215,
"290",2009,"55-59",443,259,184,
"290",2009,"60-64",326,174,152,
"290",2009,"65-69",175,110,65,
"290",2009,"70-74",128,77,51,
"290",2009,"75-79",111,51,60,
"290",2009,"80-84",70,43,27,
"290",2009,"85+",32,17,15,
"000",2010,"0-4",53996,27896,26100,
"000",2010,"5-9",50887,26038,24849,
"000",2010,"10-14",50816,26147,24669,
"000",2010,"15-19",52141,27179,24962,
"000",2010,"20-24",54419,29706,24713,
"000",2010,"25-29",55419,29307,26112,
"000",2010,"30-34",47706,24861,22845,
"000",2010,"35-39",45833,23731,22102,
"000",2010,"40-44",47141,24646,22495,
"000",2010,"45-49",54726,28398,26328,
"000",2010,"50-54",56300,29288,27012,
"000",2010,"55-59",49971,26394,23577,
"000",2010,"60-64",35938,19231,16707,
"000",2010,"65-69",22202,11714,10488,
"000",2010,"70-74",13148,6662,6486,
"000",2010,"75-79",8892,4150,4742,
"000",2010,"80-84",5985,2620,3365,
"000",2010,"85+",4711,1660,3051,
"013",2010,"0-4",123,68,55,
"013",2010,"5-9",105,55,50,
"013",2010,"10-14",88,40,48,
"013",2010,"15-19",104,63,41,
"013",2010,"20-24",249,187,62,
"013",2010,"25-29",301,208,93,
"013",2010,"30-34",213,144,69,
"013",2010,"35-39",242,182,60,
"013",2010,"40-44",355,251,104,
"013",2010,"45-49",431,299,132,
"013",2010,"50-54",340,223,117,
"013",2010,"55-59",264,174,90,
"013",2010,"60-64",171,104,67,
"013",2010,"65-69",75,46,29,
"013",2010,"70-74",33,18,15,
"013",2010,"75-79",25,14,11,
"013",2010,"80-84",15,12,3,
"013",2010,"85+",7,5,2,
"016",2010,"0-4",205,106,99,
"016",2010,"5-9",227,113,114,
"016",2010,"10-14",226,129,97,
"016",2010,"15-19",249,149,100,
"016",2010,"20-24",334,233,101,
"016",2010,"25-29",517,375,142,
"016",2010,"30-34",455,319,136,
"016",2010,"35-39",477,344,133,
"016",2010,"40-44",660,464,196,
"016",2010,"45-49",627,432,195,
"016",2010,"50-54",605,420,185,
"016",2010,"55-59",458,299,159,
"016",2010,"60-64",328,222,106,
"016",2010,"65-69",110,70,40,
"016",2010,"70-74",47,34,13,
"016",2010,"75-79",17,8,9,
"016",2010,"80-84",14,6,8,
"016",2010,"85+",5,0,5,
"020",2010,"0-4",21961,11349,10612,
"020",2010,"5-9",20618,10542,10076,
"020",2010,"10-14",20443,10407,10036,
"020",2010,"15-19",21187,10990,10197,
"020",2010,"20-24",24379,13059,11320,
"020",2010,"25-29",24820,12820,12000,
"020",2010,"30-34",20620,10458,10162,
"020",2010,"35-39",19569,9843,9726,
"020",2010,"40-44",19493,9892,9601,
"020",2010,"45-49",22394,11157,11237,
"020",2010,"50-54",22175,11084,11091,
"020",2010,"55-59",19088,9755,9333,
"020",2010,"60-64",13940,7186,6754,
"020",2010,"65-69",8347,4169,4178,
"020",2010,"70-74",4962,2328,2634,
"020",2010,"75-79",3482,1533,1949,
"020",2010,"80-84",2386,978,1408,
"020",2010,"85+",1962,659,1303,
"050",2010,"0-4",1796,911,885,
"050",2010,"5-9",1762,919,843,
"050",2010,"10-14",1669,871,798,
"050",2010,"15-19",1618,832,786,
"050",2010,"20-24",1349,688,661,
"050",2010,"25-29",1210,621,589,
"050",2010,"30-34",1047,536,511,
"050",2010,"35-39",893,457,436,
"050",2010,"40-44",965,534,431,
"050",2010,"45-49",1162,655,507,
"050",2010,"50-54",1048,579,469,
"050",2010,"55-59",850,451,399,
"050",2010,"60-64",603,330,273,
"050",2010,"65-69",451,234,217,
"050",2010,"70-74",213,117,96,
"050",2010,"75-79",194,76,118,
"050",2010,"80-84",114,56,58,
"050",2010,"85+",69,31,38,
"060",2010,"0-4",48,25,23,
"060",2010,"5-9",59,26,33,
"060",2010,"10-14",72,34,38,
"060",2010,"15-19",65,37,28,
"060",2010,"20-24",49,30,19,
"060",2010,"25-29",65,35,30,
"060",2010,"30-34",47,26,21,
"060",2010,"35-39",58,30,28,
"060",2010,"40-44",67,40,27,
"060",2010,"45-49",109,57,52,
"060",2010,"50-54",116,63,53,
"060",2010,"55-59",103,58,45,
"060",2010,"60-64",56,35,21,
"060",2010,"65-69",37,23,14,
"060",2010,"70-74",21,10,11,
"060",2010,"75-79",15,7,8,
"060",2010,"80-84",6,4,2,
"060",2010,"85+",4,0,4,
"068",2010,"0-4",114,64,50,
"068",2010,"5-9",114,59,55,
"068",2010,"10-14",118,54,64,
"068",2010,"15-19",97,52,45,
"068",2010,"20-24",49,28,21,
"068",2010,"25-29",96,40,56,
"068",2010,"30-34",136,66,70,
"068",2010,"35-39",138,70,68,
"068",2010,"40-44",131,73,58,
"068",2010,"45-49",189,109,80,
"068",2010,"50-54",191,110,81,
"068",2010,"55-59",198,111,87,
"068",2010,"60-64",118,81,37,
"068",2010,"65-69",73,44,29,
"068",2010,"70-74",37,22,15,
"068",2010,"75-79",19,14,5,
"068",2010,"80-84",5,3,2,
"068",2010,"85+",3,2,1,
"070",2010,"0-4",452,243,209,
"070",2010,"5-9",409,220,189,
"070",2010,"10-14",452,236,216,
"070",2010,"15-19",463,241,222,
"070",2010,"20-24",394,191,203,
"070",2010,"25-29",311,161,150,
"070",2010,"30-34",265,139,126,
"070",2010,"35-39",208,112,96,
"070",2010,"40-44",273,137,136,
"070",2010,"45-49",381,202,179,
"070",2010,"50-54",360,186,174,
"070",2010,"55-59",327,175,152,
"070",2010,"60-64",185,102,83,
"070",2010,"65-69",140,71,69,
"070",2010,"70-74",96,56,40,
"070",2010,"75-79",63,35,28,
"070",2010,"80-84",40,20,20,
"070",2010,"85+",28,14,14,
"090",2010,"0-4",7922,4114,3808,
"090",2010,"5-9",6985,3567,3418,
"090",2010,"10-14",6298,3274,3024,
"090",2010,"15-19",6778,3529,3249,
"090",2010,"20-24",10095,5789,4306,
"090",2010,"25-29",9030,5017,4013,
"090",2010,"30-34",7210,3809,3401,
"090",2010,"35-39",6492,3417,3075,
"090",2010,"40-44",5975,3105,2870,
"090",2010,"45-49",6625,3364,3261,
"090",2010,"50-54",6920,3536,3384,
"090",2010,"55-59",6301,3321,2980,
"090",2010,"60-64",4575,2501,2074,
"090",2010,"65-69",2637,1421,1216,
"090",2010,"70-74",1533,794,739,
"090",2010,"75-79",965,465,500,
"090",2010,"80-84",719,330,389,
"090",2010,"85+",521,178,343,
"100",2010,"0-4",128,61,67,
"100",2010,"5-9",135,62,73,
"100",2010,"10-14",141,84,57,
"100",2010,"15-19",135,64,71,
"100",2010,"20-24",79,41,38,
"100",2010,"25-29",115,55,60,
"100",2010,"30-34",131,67,64,
"100",2010,"35-39",144,70,74,
"100",2010,"40-44",161,83,78,
"100",2010,"45-49",228,119,109,
"100",2010,"50-54",250,132,118,
"100",2010,"55-59",274,140,134,
"100",2010,"60-64",242,131,111,
"100",2010,"65-69",138,70,68,
"100",2010,"70-74",78,37,41,
"100",2010,"75-79",67,28,39,
"100",2010,"80-84",32,19,13,
"100",2010,"85+",30,11,19,
"105",2010,"0-4",125,68,57,
"105",2010,"5-9",110,41,69,
"105",2010,"10-14",109,47,62,
"105",2010,"15-19",137,80,57,
"105",2010,"20-24",94,51,43,
"105",2010,"25-29",124,72,52,
"105",2010,"30-34",116,56,60,
"105",2010,"35-39",101,47,54,
"105",2010,"40-44",125,76,49,
"105",2010,"45-49",183,98,85,
"105",2010,"50-54",208,114,94,
"105",2010,"55-59",235,124,111,
"105",2010,"60-64",195,118,77,
"105",2010,"65-69",126,74,52,
"105",2010,"70-74",81,50,31,
"105",2010,"75-79",45,34,11,
"105",2010,"80-84",17,10,7,
"105",2010,"85+",19,5,14,
"110",2010,"0-4",1982,1017,965,
"110",2010,"5-9",1972,998,974,
"110",2010,"10-14",2011,1031,980,
"110",2010,"15-19",2212,1160,1052,
"110",2010,"20-24",1934,992,942,
"110",2010,"25-29",2308,1164,1144,
"110",2010,"30-34",2019,1059,960,
"110",2010,"35-39",2033,1052,981,
"110",2010,"40-44",2293,1171,1122,
"110",2010,"45-49",2669,1385,1284,
"110",2010,"50-54",2772,1407,1365,
"110",2010,"55-59",2575,1306,1269,
"110",2010,"60-64",1860,984,876,
"110",2010,"65-69",1055,515,540,
"110",2010,"70-74",667,344,323,
"110",2010,"75-79",368,156,212,
"110",2010,"80-84",298,122,176,
"110",2010,"85+",247,87,160,
"122",2010,"0-4",3464,1713,1751,
"122",2010,"5-9",3434,1773,1661,
"122",2010,"10-14",3762,1897,1865,
"122",2010,"15-19",3959,2123,1836,
"122",2010,"20-24",3066,1731,1335,
"122",2010,"25-29",3245,1746,1499,
"122",2010,"30-34",3045,1622,1423,
"122",2010,"35-39",3311,1754,1557,
"122",2010,"40-44",3544,1838,1706,
"122",2010,"45-49",4384,2287,2097,
"122",2010,"50-54",5143,2661,2482,
"122",2010,"55-59",5057,2646,2411,
"122",2010,"60-64",3710,1989,1721,
"122",2010,"65-69",2585,1441,1144,
"122",2010,"70-74",1479,794,685,
"122",2010,"75-79",1040,531,509,
"122",2010,"80-84",639,289,350,
"122",2010,"85+",533,203,330,
"130",2010,"0-4",903,454,449,
"130",2010,"5-9",857,455,402,
"130",2010,"10-14",876,435,441,
"130",2010,"15-19",937,491,446,
"130",2010,"20-24",824,445,379,
"130",2010,"25-29",983,521,462,
"130",2010,"30-34",834,432,402,
"130",2010,"35-39",783,379,404,
"130",2010,"40-44",916,463,453,
"130",2010,"45-49",1124,587,537,
"130",2010,"50-54",1175,613,562,
"130",2010,"55-59",1073,544,529,
"130",2010,"60-64",825,430,395,
"130",2010,"65-69",520,271,249,
"130",2010,"70-74",317,164,153,
"130",2010,"75-79",201,89,112,
"130",2010,"80-84",166,79,87,
"130",2010,"85+",163,59,104,
"150",2010,"0-4",1151,587,564,
"150",2010,"5-9",979,504,475,
"150",2010,"10-14",1123,601,522,
"150",2010,"15-19",1004,541,463,
"150",2010,"20-24",962,567,395,
"150",2010,"25-29",1068,576,492,
"150",2010,"30-34",955,489,466,
"150",2010,"35-39",854,446,408,
"150",2010,"40-44",936,474,462,
"150",2010,"45-49",1089,579,510,
"150",2010,"50-54",1041,573,468,
"150",2010,"55-59",875,471,404,
"150",2010,"60-64",640,345,295,
"150",2010,"65-69",403,201,202,
"150",2010,"70-74",238,122,116,
"150",2010,"75-79",126,59,67,
"150",2010,"80-84",76,31,45,
"150",2010,"85+",72,31,41,
"164",2010,"0-4",138,67,71,
"164",2010,"5-9",122,63,59,
"164",2010,"10-14",138,67,71,
"164",2010,"15-19",149,73,76,
"164",2010,"20-24",129,63,66,
"164",2010,"25-29",124,64,60,
"164",2010,"30-34",102,58,44,
"164",2010,"35-39",76,41,35,
"164",2010,"40-44",86,49,37,
"164",2010,"45-49",134,80,54,
"164",2010,"50-54",140,83,57,
"164",2010,"55-59",95,47,48,
"164",2010,"60-64",71,36,35,
"164",2010,"65-69",56,31,25,
"164",2010,"70-74",35,19,16,
"164",2010,"75-79",15,9,6,
"164",2010,"80-84",11,7,4,
"164",2010,"85+",10,2,8,
"170",2010,"0-4",6900,3616,3284,
"170",2010,"5-9",7082,3631,3451,
"170",2010,"10-14",7189,3741,3448,
"170",2010,"15-19",6985,3580,3405,
"170",2010,"20-24",5009,2670,2339,
"170",2010,"25-29",5849,3011,2838,
"170",2010,"30-34",5738,2944,2794,
"170",2010,"35-39",5946,3006,2940,
"170",2010,"40-44",6234,3236,2998,
"170",2010,"45-49",7067,3642,3425,
"170",2010,"50-54",7279,3837,3442,
"170",2010,"55-59",6364,3341,3023,
"170",2010,"60-64",4284,2219,2065,
"170",2010,"65-69",2913,1559,1354,
"170",2010,"70-74",1712,890,822,
"170",2010,"75-79",1188,589,599,
"170",2010,"80-84",730,338,392,
"170",2010,"85+",526,190,336,
"180",2010,"0-4",1017,534,483,
"180",2010,"5-9",898,450,448,
"180",2010,"10-14",857,455,402,
"180",2010,"15-19",862,447,415,
"180",2010,"20-24",730,385,345,
"180",2010,"25-29",716,387,329,
"180",2010,"30-34",626,327,299,
"180",2010,"35-39",514,269,245,
"180",2010,"40-44",541,299,242,
"180",2010,"45-49",611,339,272,
"180",2010,"50-54",622,343,279,
"180",2010,"55-59",534,288,246,
"180",2010,"60-64",361,221,140,
"180",2010,"65-69",248,140,108,
"180",2010,"70-74",141,80,61,
"180",2010,"75-79",105,44,61,
"180",2010,"80-84",73,31,42,
"180",2010,"85+",36,19,17,
"185",2010,"0-4",747,382,365,
"185",2010,"5-9",620,317,303,
"185",2010,"10-14",553,291,262,
"185",2010,"15-19",629,324,305,
"185",2010,"20-24",752,443,309,
"185",2010,"25-29",750,453,297,
"185",2010,"30-34",650,426,224,
"185",2010,"35-39",585,411,174,
"185",2010,"40-44",638,428,210,
"185",2010,"45-49",837,555,282,
"185",2010,"50-54",974,689,285,
"185",2010,"55-59",839,635,204,
"185",2010,"60-64",454,324,130,
"185",2010,"65-69",191,124,67,
"185",2010,"70-74",90,50,40,
"185",2010,"75-79",53,22,31,
"185",2010,"80-84",47,22,25,
"185",2010,"85+",21,8,13,
"188",2010,"0-4",882,464,418,
"188",2010,"5-9",688,343,345,
"188",2010,"10-14",699,344,355,
"188",2010,"15-19",710,373,337,
"188",2010,"20-24",708,388,320,
"188",2010,"25-29",550,270,280,
"188",2010,"30-34",430,244,186,
"188",2010,"35-39",399,220,179,
"188",2010,"40-44",442,267,175,
"188",2010,"45-49",488,282,206,
"188",2010,"50-54",454,258,196,
"188",2010,"55-59",356,220,136,
"188",2010,"60-64",262,141,121,
"188",2010,"65-69",146,80,66,
"188",2010,"70-74",118,69,49,
"188",2010,"75-79",94,36,58,
"188",2010,"80-84",61,19,42,
"188",2010,"85+",36,11,25,
"195",2010,"0-4",227,111,116,
"195",2010,"5-9",223,107,116,
"195",2010,"10-14",283,159,124,
"195",2010,"15-19",245,118,127,
"195",2010,"20-24",202,108,94,
"195",2010,"25-29",218,109,109,
"195",2010,"30-34",209,109,100,
"195",2010,"35-39",215,107,108,
"195",2010,"40-44",266,135,131,
"195",2010,"45-49",319,168,151,
"195",2010,"50-54",347,169,178,
"195",2010,"55-59",338,186,152,
"195",2010,"60-64",285,153,132,
"195",2010,"65-69",190,118,72,
"195",2010,"70-74",91,51,40,
"195",2010,"75-79",64,30,34,
"195",2010,"80-84",54,25,29,
"195",2010,"85+",39,19,20,
"198",2010,"0-4",416,221,195,
"198",2010,"5-9",362,182,180,
"198",2010,"10-14",416,232,184,
"198",2010,"15-19",348,205,143,
"198",2010,"20-24",303,157,146,
"198",2010,"25-29",303,165,138,
"198",2010,"30-34",303,163,140,
"198",2010,"35-39",337,169,168,
"198",2010,"40-44",368,200,168,
"198",2010,"45-49",471,264,207,
"198",2010,"50-54",488,262,226,
"198",2010,"55-59",522,295,227,
"198",2010,"60-64",363,224,139,
"198",2010,"65-69",263,158,105,
"198",2010,"70-74",137,87,50,
"198",2010,"75-79",92,54,38,
"198",2010,"80-84",42,19,23,
"198",2010,"85+",25,13,12,
"220",2010,"0-4",624,343,281,
"220",2010,"5-9",561,278,283,
"220",2010,"10-14",546,302,244,
"220",2010,"15-19",560,283,277,
"220",2010,"20-24",519,242,277,
"220",2010,"25-29",613,299,314,
"220",2010,"30-34",641,330,311,
"220",2010,"35-39",604,311,293,
"220",2010,"40-44",561,297,264,
"220",2010,"45-49",649,333,316,
"220",2010,"50-54",787,391,396,
"220",2010,"55-59",696,350,346,
"220",2010,"60-64",512,281,231,
"220",2010,"65-69",319,166,153,
"220",2010,"70-74",257,119,138,
"220",2010,"75-79",165,68,97,
"220",2010,"80-84",130,53,77,
"220",2010,"85+",137,35,102,
"230",2010,"0-4",49,27,22,
"230",2010,"5-9",33,18,15,
"230",2010,"10-14",35,17,18,
"230",2010,"15-19",46,20,26,
"230",2010,"20-24",39,19,20,
"230",2010,"25-29",82,36,46,
"230",2010,"30-34",107,47,60,
"230",2010,"35-39",66,40,26,
"230",2010,"40-44",93,52,41,
"230",2010,"45-49",68,36,32,
"230",2010,"50-54",88,48,40,
"230",2010,"55-59",103,61,42,
"230",2010,"60-64",71,41,30,
"230",2010,"65-69",41,16,25,
"230",2010,"70-74",22,14,8,
"230",2010,"75-79",9,2,7,
"230",2010,"80-84",10,4,6,
"230",2010,"85+",6,2,4,
"240",2010,"0-4",486,236,250,
"240",2010,"5-9",529,304,225,
"240",2010,"10-14",509,273,236,
"240",2010,"15-19",510,267,243,
"240",2010,"20-24",377,192,185,
"240",2010,"25-29",433,246,187,
"240",2010,"30-34",460,267,193,
"240",2010,"35-39",429,235,194,
"240",2010,"40-44",483,284,199,
"240",2010,"45-49",567,335,232,
"240",2010,"50-54",605,328,277,
"240",2010,"55-59",562,330,232,
"240",2010,"60-64",415,254,161,
"240",2010,"65-69",274,173,101,
"240",2010,"70-74",188,100,88,
"240",2010,"75-79",101,53,48,
"240",2010,"80-84",63,29,34,
"240",2010,"85+",38,11,27,
"261",2010,"0-4",621,309,312,
"261",2010,"5-9",625,318,307,
"261",2010,"10-14",679,327,352,
"261",2010,"15-19",672,360,312,
"261",2010,"20-24",552,308,244,
"261",2010,"25-29",595,335,260,
"261",2010,"30-34",543,289,254,
"261",2010,"35-39",554,284,270,
"261",2010,"40-44",663,353,310,
"261",2010,"45-49",850,462,388,
"261",2010,"50-54",1012,540,472,
"261",2010,"55-59",849,482,367,
"261",2010,"60-64",623,352,271,
"261",2010,"65-69",355,207,148,
"261",2010,"70-74",196,99,97,
"261",2010,"75-79",116,66,50,
"261",2010,"80-84",70,32,38,
"261",2010,"85+",61,20,41,
"270",2010,"0-4",903,495,408,
"270",2010,"5-9",829,424,405,
"270",2010,"10-14",861,459,402,
"270",2010,"15-19",821,414,407,
"270",2010,"20-24",724,407,317,
"270",2010,"25-29",480,241,239,
"270",2010,"30-34",367,191,176,
"270",2010,"35-39",374,211,163,
"270",2010,"40-44",405,208,197,
"270",2010,"45-49",423,224,199,
"270",2010,"50-54",365,208,157,
"270",2010,"55-59",285,156,129,
"270",2010,"60-64",218,117,101,
"270",2010,"65-69",139,75,64,
"270",2010,"70-74",105,45,60,
"270",2010,"75-79",79,37,42,
"270",2010,"80-84",40,17,23,
"270",2010,"85+",41,15,26,
"275",2010,"0-4",129,60,69,
"275",2010,"5-9",136,65,71,
"275",2010,"10-14",155,84,71,
"275",2010,"15-19",152,86,66,
"275",2010,"20-24",116,70,46,
"275",2010,"25-29",115,60,55,
"275",2010,"30-34",88,42,46,
"275",2010,"35-39",114,59,55,
"275",2010,"40-44",127,57,70,
"275",2010,"45-49",186,102,84,
"275",2010,"50-54",243,130,113,
"275",2010,"55-59",235,123,112,
"275",2010,"60-64",199,110,89,
"275",2010,"65-69",123,64,59,
"275",2010,"70-74",110,62,48,
"275",2010,"75-79",66,36,30,
"275",2010,"80-84",42,21,21,
"275",2010,"85+",33,11,22,
"282",2010,"0-4",40,17,23,
"282",2010,"5-9",42,22,20,
"282",2010,"10-14",41,19,22,
"282",2010,"15-19",53,28,25,
"282",2010,"20-24",34,16,18,
"282",2010,"25-29",42,27,15,
"282",2010,"30-34",36,17,19,
"282",2010,"35-39",46,28,18,
"282",2010,"40-44",48,28,20,
"282",2010,"45-49",56,35,21,
"282",2010,"50-54",54,32,22,
"282",2010,"55-59",60,39,21,
"282",2010,"60-64",46,24,22,
"282",2010,"65-69",23,14,9,
"282",2010,"70-74",20,12,8,
"282",2010,"75-79",9,1,8,
"282",2010,"80-84",7,0,7,
"282",2010,"85+",5,1,4,
"290",2010,"0-4",443,234,209,
"290",2010,"5-9",371,182,189,
"290",2010,"10-14",467,237,230,
"290",2010,"15-19",454,249,205,
"290",2010,"20-24",368,206,162,
"290",2010,"25-29",356,193,163,
"290",2010,"30-34",313,185,128,
"290",2010,"35-39",271,137,134,
"290",2010,"40-44",292,152,140,
"290",2010,"45-49",405,211,194,
"290",2010,"50-54",498,269,229,
"290",2010,"55-59",455,266,189,
"290",2010,"60-64",326,176,150,
"290",2010,"65-69",224,139,85,
"290",2010,"70-74",124,75,49,
"290",2010,"75-79",109,54,55,
"290",2010,"80-84",78,44,34,
"290",2010,"85+",34,18,16,
